theatron,	थित्रों,	थियेटरों,	
truth,	त्रथ,	ट्रुथ,	
pipra,	पिपरा,	पिपरा,	
jaddit,	जदद्तित,	जड़ित,	
sultana,	सुल्ताना,	सुलताना,	
chanval,	चानवाल,	चांवल,	
palatne,	पलटते,	पलटने,	
agavai,	अगवाई,	अगवाई,	
ghumakkadon,	घुमक्ककों,	घुमक्कड़ों,	
kaku,	काकू,	काकू,	
chikhali,	चिखली,	चिखली,	
atwaal,	अत्वाल,	अटवाल,	
billa,	बिल्ला,	बिल्ला,	
clasen,	क्लेसन,	क्लासें,	
chhaviyaan,	छावियां,	छवियाँ,	
jeewan,	जीवन,	जीवन,	
faansi,	फांसी,	फांसी,	
dukhon,	दुखों,	दुखों,	
aswabhavik,	अस्वाभाविक,	अस्वभाविक,	
chuka,	चुका,	चुका,	
kamtar,	कामतार,	कमतर,	
nagaadaa,	नगदा,	नगाड़ा,	
nrutyashaili,	नृत्यशशली,	नृत्यशैली,	
pratibhutiyan,	प्रतिभूतियां,	प्रतिभूतियां,	
chai,	चाय,	छै,	
mahavidya,	महाविद्य,	महाविद्या,	
zee,	जी,	ज़ी,	
agashe,	अगशे,	आगाशे,	
naram,	नरम,	नरम,	
failegi,	फैलेगी,	फैलेगी,	
apriyary,	अपरियार्य,	अपरिहार्य,	
jainon,	जैनों,	जैनों,	
badlapur,	बदलापुर,	बदलापुर,	
dhtuen,	ध्तुएं,	धातुएं,	
piega,	पीएगा,	पिएगा,	
aamdani,	आमदनी,	आमदनी,	
karnataka,	कर्णतका,	कर्नाटका,	
kanthhar,	कंठहर,	कंठहार,	
chayal,	चयाल,	चायल,	
mardon,	मार्डों,	मर्दों,	
programs,	प्रोग्रामस,	प्रोग्रामर्स,	
salahkar,	सलाकर,	सलाहकार,	
parshdon,	पार्शों,	पार्षदों,	
breed,	ब्रीड,	ब्रीद,	
chhuri,	छुरी,	छुरी,	
talbagaar,	तालबागर,	तलबगार,	
dhamkata,	धमकता,	धमकाता,	
khoikhoi,	खोइोो,	खोईखोई,	
gadadhar,	गडाधार,	गदाधर,	
vadak,	वादक,	वादक,	
favvaron,	फाववरों,	फव्वारों,	
judaai,	जुदाई,	जुदाई,	
chauka,	चौका,	चौका,	
yaatanaon,	यातनाओं,	यातनाओं,	
chausingha,	चौसिंहा,	चौसिंगा,	
neetiyon,	नीतियों,	नीतियों,	
urdhav,	उर्धाव,	ऊर्ध्व,	
ubal,	उबल,	उबाल,	
kagaz,	कागज,	कागज़,	
veronika,	वेरोणिका,	वेरोनिका,	
shaasakon,	शासकों,	शासकों,	
jadein,	जाड़ें,	जड़ें,	
julahon,	जुलाहों,	जुलाहों,	
less,	लेस,	लैस,	
shasak,	शासक,	शासक,	
britain,	ब्रिटानन,	ब्रिटेन,	
ujback,	उजबकक,	उज़्बेक,	
sthitiyaan,	स्थितियां,	स्थितियां,	
aparivartanshali,	अपरिवर्तनशीली,	अपरिवर्तनशील,	
ea,	ईए,	ईए,	
bang,	बंग,	बंग,	
suken,	सूकेन,	सुजेन,	
chhapemar,	छापेमार,	छापेमार,	
mta,	एमटीए,	एमटीए,	
navanagar,	नवननगर,	नवानगर,	
rajinaama,	रजीनामा,	राजीनामा,	
bilae,	बिलाए,	बिलाई,	
varshan,	वर्षण,	वर्शन,	
massachusetts,	मेसाचुसेट्स,	मैसाचुसेट्स,	
paheliyan,	पहललियां,	पहेलियां,	
usi,	उसी,	उसी,	
labdh,	लब्ब,	लब्ध,	
kasarat,	कसारत,	कसरत,	
killat,	किल्ट,	किल्लत,	
andrabi,	अंदराबी,	अंद्राबी,	
lbdh,	एलबीड,	लब्ध,	
paathshaalaayein,	पाठशालाएं,	पाठशालाएं,	
patiya,	पटिया,	पटिया,	
chhai,	छाई,	छै,	
karoor,	करूर,	करूर,	
haalchal,	हाचलाल,	हालचाल,	
satane,	सतने,	सताने,	
uda,	उड़ा,	उदा,	
daisy,	दैसी,	डेजी,	
namdhari,	नामधारी,	नामधारी,	
kanyayen,	कन्यायें,	कन्याएं,	
koling,	कोलिंग,	कोलिंग,	
pik,	पिक,	पिक,	
jagruti,	जागृती,	जागृति,	
gatisheel,	गतिशील,	गतिशील,	
lodi,	लोडी,	लोदी,	
bhartnatyam,	भार्तनात्मम,	भरतनाट्यम्,	
fagua,	फागु,	फगुआ,	
cbse,	सीबीएस,	सीबीएसई,	
dravani,	द्रवानी,	डरावनी,	
kapdon,	कप़्ों,	कपड़ो,	
als,	एल्स,	एएलएस,	
obrayan,	ओब्रययन,	ओब्रायन,	
pakshpat,	पश्षपतत,	पक्षपात,	
atharv,	अथर्व,	अथर्व,	
aadhin,	आधीन,	आधीन,	
thakkr,	ठक्कर,	ठक्कर,	
pehnate,	पहनाते,	पहनता,	
abvp,	एबीवी,	एबीवीपी,	
kavvaliyon,	क़व्वलियों,	कव्वालियों,	
nishpaap,	निष्पाप,	निष्पाप,	
dhndhe,	ढुंधे,	धंधे,	
mardani,	मर्दानी,	मरदानी,	
rigs,	रिग्स,	रिग्स,	
leedaron,	लीदारों,	लीडरों,	
chatunshkoniy,	चतुंशकनीीय,	चतुष्कोणीय,	
gypsy,	जिप्सी,	जिप्सी,	
changed,	चंजेड,	चेंज्ड,	
bolane,	बोलने,	बोलने,	
layega,	लायगा,	लायेगा,	
ashriton,	अश्रीतों,	आश्रितों,	
panapnaa,	पननपना,	पनपना,	
khalnayak,	खलननायक,	खलनायक,	
cricket,	क्रिक्ट,	क्रिकेट,	
raubadaar,	रौबदार,	रौबदार,	
physician,	फिजिसन,	फिजिशियन,	
jhalla,	झल्ला,	झल्ला,	
daabholkar,	दाभोलकार,	दाभोलकर,	
parshad,	पारशाद,	पार्षद,	
pushpa,	पुष्प,	पुष्पा,	
mass,	मस,	मास,	
rate,	रेट,	रेत,	
alochak,	अलोचक,	आलोचक,	
raji,	रजी,	राजी,	
finger,	फिंगर,	फिंगर,	
afroj,	अफरोज़,	अफरोज,	
nano,	नानो,	नैनो,	
barhad,	बाहह,	बरहद,	
sanchaari,	संचारी,	संचारी,	
vaitrawati,	वैत्रवती,	वैत्रवती,	
atta,	अत्ता,	आटा,	
lycopene,	लाइकोपन,	लाइकोपिन,	
shbana,	शबाना,	शबाना,	
vigyan,	विज्ञान,	विज्ञान,	
jalgti,	जलत्ी,	जलगति,	
shield,	शील्ड,	सील्ड,	
rodolph,	रोडोल्फ,	रुडोल्फ,	
bhumika,	भूमिका,	भूमी,	
atthaas,	अत्थास,	अट्टहास,	
thiyeters,	थियटर्स,	थियेटर्स,	
perabola,	पैरेबोला,	पैराबोला,	
sevai,	सेवाई,	सेंवई,	
ishat,	ईशात,	ईष्ट,	
parikalpit,	परिकल्पित,	परिकल्पित,	
jaidayal,	जैदयाल,	जयदयाल,	
chhah,	छाह,	छह,	
samalakha,	समलाखा,	समालखा,	
ukhrool,	उखरूल,	उखरुल,	
sanyojnon,	संयोजनों,	संयोजनों,	
naksal,	नकसाल,	नक्सल,	
taoo,	ताऊ,	टाऊ,	
bandhte,	बांधेते,	बांधते,	
sikud,	सिक्डड़,	सिकुड़,	
failaea,	फैलाई,	फैलाइए,	
shrankhalaaon,	श्रृंखलाओं,	श्रंखलाओं,	
beemon,	बीमों,	बीमों,	
boriwali,	बोरिवाली,	बोरीवली,	
polish,	पॉलिश,	पोलिश,	
nazarandaaz,	नज़रंदाज़,	नजरंदाज,	
daakhil,	दाख़िल,	दाखिल,	
theatre,	थित्े,	थियेटर,	
ghoonsa,	घूंसा,	घूंसा,	
winter,	विंटर,	विंटर,	
tani,	तानी,	तनी,	
watanukoollan,	वाटनुुुल्नन,	वातानुकूलन,	
zarakh,	जरखाख,	जरख,	
warrior,	वेरियर,	वारियर्स,	
akhet,	अखेत,	आखेट,	
jh,	झ,	झ,	
standhari,	स्तंधारी,	स्तनधारी,	
ankhon,	अंखों,	अंकों,	
cradle,	क्रैडल,	क्रैडल,	
navjagran,	नवजागरण,	नवजागरण,	
nagaaraa,	नगारा,	नगाड़ा,	
chhaati,	छाती,	छाती,	
napne,	नापने,	नापने,	
gsm,	जीएसएम,	जीएसएम,	
ambani,	अमबानी,	अम्बानी,	
manga,	मंगा,	मांगा,	
khinchkar,	खींचकर,	खींचकर,	
scandinavia,	स्कांडिनेयि,	स्कैंडिनेविया,	
gujarta,	गुजरता,	गुजारता,	
stan,	स्टान,	स्तन,	
girish,	गिरिश,	गिरीश,	
jetha,	जेठा,	जेठा,	
vytit,	वित्ति,	व्यतीत,	
aram,	एरम,	आराम,	
dhaatuein,	धातुएं,	धातुएं,	
selfie,	सेल्फी,	सेल्फी,	
durniti,	दूर्णीती,	दुर्नीति,	
chhutne,	छुटने,	छूटने,	
taza,	ताजा,	ताजा,	
plus,	प्लस,	पल्स,	
khate,	खाते,	खाते,	
sanasthit,	संस्थित,	संस्थित,	
achhi,	अछी,	अच्छी,	
ehsaas,	एहसास,	एहसास,	
gruhnagar,	गृहनागर,	गृहनगर,	
chatagaon,	चटागाओं,	चटगांव,	
mohana,	मोहनान,	मोहाना,	
jajaon,	जाज़ाओं,	जजों,	
maule,	मौले,	मौले,	
mejbaan,	मेजबान,	मेज़बान,	
kisanon,	किसनों,	किसानों,	
sthiti,	स्थिति,	स्तिथि,	
douglas,	डागलास,	डगलस,	
chhahon,	छाहों,	छहों,	
dhokhebaaj,	धोखेबाज,	धोखेबाज,	
wade,	वाद,	वेड,	
bhumi,	भूमि,	भुमि,	
bewkufana,	बेकूफफाना,	बेवकूफाना,	
swikarte,	स्वीकारते,	स्वीकारते,	
bulao,	बुलाओ,	बुलाओ,	
bangsh,	बांगश,	बंगश,	
putin,	पूटीन,	पुतिन,	
landal,	लंडल,	लेंडल,	
owem,	ओवम,	ओवम,	
durghtna,	दुर्घटना,	दुर्घटना,	
recer,	रेसर,	रेसर,	
urvarkon,	उर्वारों,	उर्वरकों,	
vaigyaanikta,	वैग्ञानिकता,	वैज्ञानिकता,	
ail,	एल,	ऐल,	
dakhile,	दखखलले,	दाखिले,	
fadfadata,	फड़फदाता,	फड़फड़ाता,	
dhandhe,	ढंधे,	धंधे,	
rantle,	रंतल,	रेंटल,	
rounder,	राउंडर,	राउंडर,	
dhak,	ढक,	धाक,	
dangerous,	डेंटोरूस,	डेंजरस,	
nayak,	नायक,	नायक,	
safety,	सेफ़्टी,	सेफ्टी,	
nitiyon,	नितियों,	नितियों,	
pehan,	पहन,	पहन,	
deepsingh,	दीपसिंह,	दीपसिंह,	
rushikul,	ऋषिकुल,	ऋषिकुल,	
gunga,	गुंगा,	गूंगा,	
bikaneri,	बिकननरी,	बीकानेरी,	
naxalvaaad,	नकलवााद,	नक्सलवाद,	
bhanu,	भानु,	भानू,	
racreation,	रैक्रेशन,	रिक्रिएशन,	
picking,	पिकिंग,	पीकिंग,	
paarshad,	पारशाद,	पार्षद,	
maas,	मांस,	मास,	
asphalt,	असफफल्ट,	एस्फाल्ट,	
vaigyaanik,	वैज्ञानिक,	वैज्ञानिक,	
chandana,	चंदना,	चंदन,	
chaukhate,	चौखतेत,	चौखटे,	
baramade,	बरममडे,	बरामदे,	
sthool,	स्थूल,	स्थूल,	
samanjasya,	समांजास्य,	सामंजस्य,	
bechte,	बेचते,	बेचते,	
antrmukh,	अंतर्मुख,	अंतर्मुख,	
kathfodave,	कथ्ोोदेवे,	कठफोड़वे,	
reja,	रेजा,	रेजा,	
borkar,	बोर्कर,	बोरकर,	
gaye,	गाये,	गए,	
salary,	सालारी,	सैलरी,	
palaari,	पलारी,	पलारी,	
sajsajja,	सजजसाज,	साजसज्जा,	
ved,	वेड,	वेड,	
parshadon,	पारशादों,	पार्षदों,	
samahar,	समाहार,	समाहार,	
jatakon,	जटकों,	जातकों,	
yariyan,	यारियां,	यारियां,	
uniyal,	उूनियल,	उनियाल,	
tarabai,	तरबाई,	ताराबाई,	
anthak,	अंतक,	अनथक,	
amogh,	अमोग,	अमोघ,	
ghumakkdon,	घुमक्कों,	घुमक्कड़ों,	
ajmeedh,	अजमीद,	अजमीढ़,	
slaaidon,	स्लाइडों,	स्लाइडों,	
slides,	स्लीइडस,	स्लाइड्स,	
dubaana,	दुबाना,	डुबाना,	
patkathaein,	पट्थाथें,	पटकथाएं,	
masaledar,	मसलेदार,	मसालेदार,	
longewal,	लोंगेवाल,	लोंगोवाल,	
amod,	अमोद,	आमोद,	
longewala,	लोंगेवाला,	लोंगोवाल,	
tyoiharon,	त्योहारों,	त्यौहारों,	
log,	लॉग,	लोग,	
kaasht,	काष्ट,	काश्त,	
vyavadhan,	व्यवधान,	व्यवधान,	
devisingh,	डिविसिंह,	देवीसिंह,	
colon,	कोलोन,	कोलन,	
libration,	लाइब्रेशन,	लिब्रेशन,	
rishicool,	रिशककूल,	ऋषिकुल,	
faisala,	फ़ससला,	फ़ैसला,	
barsaata,	बरसाता,	बरसाता,	
chhalla,	छल्ला,	छल्ला,	
mithai,	मिथाई,	मिठाई,	
bhutal,	भुताल,	भूतल,	
prayaasrat,	प्रयास्तत,	प्रयासरत,	
dhokhebaj,	धोखेबाज,	धोखेबाज,	
sweta,	स्वेता,	स्वेता,	
dikhaai,	दिखाई,	दिखाई,	
praathmikata,	प्राथ्थिकता,	प्राथमिकता,	
picture,	पिक्टर,	पिक्चर,	
chalenge,	चलेंगे,	चलेंगे,	
barsata,	बरसता,	बरसाता,	
praroop,	प्ररूप,	प्रारूप,	
ukhrul,	उख्रुल,	उखरुल,	
raak,	राक,	राक,	
bhusi,	भुसी,	भूसी,	
sweekarte,	स्वीकारते,	स्वीकारते,	
saman,	सामन,	समन,	
riya,	रिया,	रिया,	
jua,	जुआ,	जुए,	
kathai,	कथाई,	कत्थई,	
dhundhi,	धुंधी,	ढूंढी,	
stuti,	स्तुती,	स्तुति,	
parishadiy,	परिशदीीय,	परिषदीय,	
aalha,	आल्हा,	आल्हा,	
awasthaen,	अवस्थाएं,	अवस्थाएं,	
dekhoge,	देखोज़,	देखोगे,	
anukulata,	अनुकुलता,	अनुकूलता,	
updravon,	उपद्रवों,	उपद्रवों,	
pharmacy,	फर्मासी,	फार्मेसी,	
updravi,	उपद्ववी,	उपद्रवी,	
kalraj,	कलराज,	कलराज,	
vishhin,	विश्नीन,	विषहीन,	
uthapatak,	उठापता,	उठापटक,	
solicitor,	सॉलीसिटर,	सॉलिसिटर,	
strokes,	स्ट्रोक्स,	स्ट्रोक्स,	
nityaa,	नित्या,	नित्या,	
box,	बॉक्स,	बाॅक्स,	
angaarak,	अंगारक,	अंगारक,	
phalne,	फलने,	फलने,	
vivekheen,	विवेखीन,	विवेकहीन,	
baithantey,	बैठंते,	बैठते,	
dhokebaaz,	धोकेबाज,	धोखेबाज,	
melaghaat,	मेलाघात,	मेलघाट,	
junior,	ज्यूनर,	जूनियर,	
patakkar,	पटककर,	पटककर,	
uthen,	उठाें,	उठें,	
wesle,	वेसले,	वेस्ले,	
matthe,	मत्थे,	मत्थे,	
jenrick,	जेनरकक,	जेनरिक,	
makrani,	मकरानी,	मकरानी,	
abantit,	अबंतित,	आबंटित,	
sajja,	सज्जा,	सज्जा,	
reshe,	रेश,	रेशे,	
bhabar,	भाबर,	भाबर,	
jagayega,	जगाएगा,	जगाएगा,	
lakir,	लकीिर,	लकीर,	
vipreetataa,	विप्रीतता,	विपरीतता,	
pathykram,	पाठ्य्रम,	पाठ्यक्रम,	
chhetr,	छेत्र,	छेत्र,	
hardas,	हरदस,	हरदास,	
khushiyan,	खुशियां,	खुशियां,	
anuchit,	अनुच्छित,	अनुचित,	
bangbhang,	बांगभंग,	बंगभंग,	
naseem,	नसीम,	नसीम,	
kinote,	किनोट,	कीनोट,	
jaiban,	जैबनन,	जयबाण,	
muller,	म्यूलर,	मूलर,	
mario,	मारियो,	मारियो,	
judai,	जुदाई,	जुड़ाई,	
ananti,	अनाती,	अनंती,	
bhranti,	भ्राती,	भ्रांति,	
bhraanti,	भ्रांति,	भ्रांति,	
swipe,	स्वाइप,	स्वैप,	
parafin,	पराफीन,	पैराफिन,	
sutali,	सूतली,	सुतली,	
convention,	कन्वेशन,	कन्वेंशन,	
bramad,	भ्रमद,	बरामद,	
vidyaayein,	विद्याएं,	विद्याएं,	
badhotari,	बढ़ोतरी,	बढ़ोतरी,	
sujhati,	सुझाती,	सुझाती,	
composer,	कॉपोसर,	कंपोजर,	
sanskurt,	संस्कृत,	संस्कृत,	
haarjeet,	हारजीत,	हारजीत,	
borivali,	बोरिवाली,	बोरीवली,	
robin,	रॉबिन,	राबिन,	
stone,	स्टोन,	स्टोन,	
jayadayal,	जययदाल,	जयदयाल,	
tau,	ताऊ,	टाऊ,	
formic,	फॉर्मिक,	फार्मिक,	
julus,	जुलूस,	जूलूस,	
pagalaa,	पगला,	पगला,	
saparivaar,	सपररिवार,	सपरिवार,	
avshisht,	अवशिष्ट,	अवशिष्ट,	
ukrainian,	उक्रेनिन,	यूक्रेनियन,	
lte,	ललट,	एलटीई,	
hiraganj,	हीरागंज,	हीरागंज,	
asan,	असन,	आसान,	
shirke,	शिरके,	शिर्के,	
menu,	मेनू,	मेनू,	
pehnakar,	पहनाकर,	पहनाकर,	
bheesham,	भीषम,	भीष्म,	
gaanth,	गांठ,	गांठ,	
astar,	अस्तार,	एस्टर,	
niptara,	निपटारा,	निपटारा,	
agra,	आग्र,	अग्र,	
mulon,	मूलों,	मूलों,	
sutli,	सुतली,	सुतली,	
rasayanika,	रसायनिका,	रसायनिक,	
dhunaai,	धुनाई,	धुनाई,	
najarandaaj,	नज़रंदाज़,	नजरंदाज,	
tainin,	टैनिन,	टैनिन,	
erika,	एरीका,	एरिका,	
nehara,	नेहरा,	नेहरा,	
khaate,	खाते,	खाते,	
dadrewa,	ददरेवा,	ददरेवा,	
tippanikar,	तिप्पणिकार,	टिप्पणीकार,	
ferth,	फर्थ,	फर्थ,	
dikhae,	दिखाए,	दिखार्इ,	
ghumakkdi,	घुमक्कडी,	घुमक्कड़ी,	
lassi,	लासी,	लस्सी,	
rollers,	रॉलर्स,	रोलर्स,	
shutting,	शुटिंग,	शुटिंग,	
susanskrit,	सुसंस्कृत,	सुसंस्कृत,	
mhajan,	महाजान,	महाजन,	
simatta,	सीमतता,	सिमटता,	
greist,	ग्रेस्ट,	ग्रीस्ट,	
jgaayega,	जगाएगा,	जगाएगा,	
pataraani,	पत्रणी,	पटरानी,	
ladaaiyon,	लड़ाइयों,	लड़ाईयों,	
dhamm,	धम्म,	धम्म,	
jivaniyaan,	जीवनीययां,	जीवनियां,	
sarahind,	सरहहंं,	सरहिंद,	
seaten,	सीटन,	सीटें,	
darmiyaan,	दरमियान,	दरमियान,	
media,	मीडिया,	मिडिया,	
ikhrul,	इखरूल,	उखरुल,	
machaanon,	मचानों,	मचानों,	
motive,	मोटिव,	मोटिव,	
raakhe,	राखे,	राखे,	
pharmon,	फर्मों,	फार्मों,	
teji,	तेज़ी,	तेजी,	
kalpnaon,	कल्पनाओं,	कल्पनाओं,	
gangrel,	गैंगरल,	गंगरेल,	
jeevraaj,	जीवराज,	जीवराज,	
dardara,	दरदारा,	दरदरा,	
bavaji,	बवाजी,	बावजी,	
bholu,	भोलू,	भोलू,	
purvabhaas,	पूर्वभास,	पूर्वाभास,	
lahna,	लहना,	लहना,	
ghumaan,	घुमान,	घुमाण,	
kritika,	कृतिका,	कृतिका,	
loge,	लोज,	लोगे,	
sweep,	स्वीप,	स्वीप,	
jealous,	ज्लोस,	जूलूस,	
sabhaen,	सभाएं,	सभाएं,	
mausa,	मौसा,	मौसा,	
yatna,	यतना,	यातना,	
mosad,	मोस्द,	मोसाद,	
dikhayi,	दिखाई,	दिखार्इ,	
qazi,	काज़ी,	काजी,	
facial,	फेशिलल,	फेशियल,	
patili,	पटिली,	पतीली,	
vlad,	व्लैड,	व्लाद,	
mohani,	मोहनी,	मोहानी,	
tyoharon,	त्योहारों,	त्यौहारों,	
chatgaon,	चत्गाओं,	चटगांव,	
pagabadha,	पगाबड़ा,	पगबाधा,	
iris,	आइरिस,	आईरिस,	
association,	एसोसिएशन,	एसोसिएशन,	
paradheen,	पराधीन,	पराधीन,	
rajnitikaran,	राजनीतीकरण,	राजनीतीकरण,	
pahla,	पहला,	पहला,	
samprabhu,	संप्रभू,	संप्रभु,	
pied,	पीएड,	पाइड,	
runners,	रननर्स,	रनर्स,	
immune,	इम्यून,	इम्युन,	
prashasanik,	प्रशस्निक,	प्रशासनिक,	
kundal,	कुंडल,	कुंडल,	
bhraant,	भ्रांत,	भ्रांत,	
antarmukh,	अंतर्मुख,	अंतर्मुख,	
vanita,	वाणिता,	वनिता,	
mhapran,	महाप्राण,	महाप्राण,	
yorker,	यार्कर,	यॉर्कर,	
fod,	फोड,	फोड़,	
ulema,	उल्मेमा,	उलेमा,	
sprit,	स्प्रित,	स्प्रिट,	
rudolph,	रूडोल्फ,	रुडोल्फ,	
bag,	बाग,	बाग,	
sakara,	सकरा,	सकरा,	
dvc,	डीवीसी,	डीवीसी,	
farmion,	फर्ममयन,	फर्मिऑन,	
girjaghar,	गिरजाघार,	गिरजाघर,	
mitaao,	मिताओ,	मिटाओ,	
nori,	नॉरी,	नोरी,	
avantipur,	अवंतीपुर,	अवंतिपुर,	
jamaate,	जमाते,	जमाती,	
bhula,	भुला,	भूला,	
batlae,	बतलाई,	बतलाए,	
labelling,	लेबेलिंग,	लेबलिंग,	
guan,	गुण,	गुआन,	
aliance,	एलाइंस,	अलायंस,	
emile,	एमिलल,	एमिल,	
bagad,	बगाद,	बगड़,	
hamlavar,	हमलावर,	हमलावर,	
chupaty,	चुपत्,	चौपाटी,	
swachalit,	स्वचालित,	स्वाचालित,	
rectare,	रिक्टरे,	रैकेटियर,	
joki,	जोकी,	जोकि,	
kush,	कुश,	कुश,	
favvara,	फाववरा,	फव्वारा,	
aamdan,	आमदन,	आमदन,	
deshke,	देशके,	देशके,	
brocken,	ब्रॉकन,	ब्रोकन,	
viththal,	विथ्थाल,	विठ्ठल,	
chauk,	चौक,	चौक,	
traded,	ट्रेड्ड,	ट्रेडेड,	
handiya,	हंंडिया,	हंडिया,	
velur,	वेलर,	वेल्लूर,	
mayorka,	मयोरका,	मयोर्का,	
diwani,	दीवानी,	दिवानी,	
duak,	दुक,	ड्यूक,	
jokhim,	जोखिम,	जोखिम,	
niyanta,	नियांता,	नियंता,	
speller,	स्पेलर,	स्पेलर,	
sayra,	सायरा,	सायरा,	
huppar,	हुप्पर,	हूपर,	
parda,	परदा,	पर्दा,	
amjhera,	अमजेरा,	अमझेरा,	
vidhansabhaen,	विधानसंायं,	विधानसभाएं,	
tarkwaad,	तर्कवाद,	तर्कवाद,	
tuglaki,	तुगलाकी,	तुगलकी,	
candidate,	कैंडीगेट,	कैंडिडेट,	
chenkein,	चेंकेन,	छींके,	
very,	वेरी,	वैरी,	
ayodhyanath,	अयोध्यनाथ,	अयोध्यानाथ,	
pehla,	पहला,	पहला,	
aarushi,	आरुषी,	आरुषि,	
banaam,	बनाम,	बनाम,	
mahamantra,	महामंत्र,	महामंत्र,	
sthitiyon,	स्थितियों,	स्थितियों,	
haqeeqat,	हाीकत,	हकीकत,	
pastry,	पास्ट्री,	पेस्ट्री,	
sanshayon,	संशाषों,	संशयों,	
sapatey,	सपते,	सपाटे,	
asmanye,	असमान्य,	असमान्य,	
proof,	प्रूफ,	प्रूफ,	
aashanka,	आशंका,	आशंका,	
jaydayal,	जयदााल,	जयदयाल,	
dita,	डीता,	दिता,	
richual,	रिचुलल,	रिचुअल,	
mold,	मोल्ड,	मोल्ड,	
asamanjasy,	असमंजंसी,	असामंजस्य,	
sulkhan,	सुलखनन,	सुलखान,	
kahaniyon,	कहानियों,	कहानियों,	
sanyog,	संयोग,	संयुक्त,	
udanen,	उड़नें,	उड़ानें,	
davey,	देवे,	डेवी,	
scaining,	स्केनिंग,	स्कैनिंग,	
economic,	इकनॉॉमिक,	इकोनोमिक,	
mehaman,	मेहमन,	मेहमान,	
bhishm,	भिष्म,	भीष्म,	
sulzai,	सुलझाई,	सुलझाई,	
lindon,	लिंडन,	लिंडन,	
dhundhta,	ढुंधता,	ढूंढता,	
hui,	हुई,	हुईं,	
raubadar,	रौबादार,	रौबदार,	
gtod,	ग्टोड,	जीतोड़,	
purple,	पर्पल,	पर्पल,	
isht,	ईष्ट,	इष्ट,	
awazen,	आवाजें,	आवाज़ें,	
garibi,	गरीबी,	गरीबी,	
sanjay,	संजय,	संजय,	
bhrantiyan,	भ्रंतियां,	भ्रांतियां,	
saptari,	सप्तरी,	सप्तरी,	
talvon,	तलवों,	तलवों,	
adain,	अडेन,	एडेन,	
haalchaal,	हालचाल,	हालचाल,	
fatehgarh,	फतेहाढ़,	फतेहगढ़,	
taraash,	तराश,	तराश,	
chandramaon,	चंद्रमाओं,	चंद्रमाओं,	
samahaar,	समाहार,	समाहार,	
anishwarvadi,	अनिश्ववर्दी,	अनीश्वरवादी,	
sandarbh,	संदर्भ,	संदर्भ,	
dhandhany,	ढांढन्य,	धनधान्य,	
hegde,	हेग्डे,	हेगडे,	
alagavavadi,	अलगववादी,	अलगाववादी,	
darra,	दररा,	दर्रा,	
asi,	एसी,	एएसआई,	
kumawat,	कुमावत,	कुमावत,	
gangajal,	गंगजल,	गंगाजल,	
awantipora,	अवंतीपोर,	अवंतिपुर,	
jutee,	जुती,	जुटी,	
nazeem,	नज़ीम,	नजीम,	
gayen,	गाये,	गाएं,	
padaraunaa,	पदारौणा,	पडरौना,	
cup,	कूप,	कप,	
chune,	चुने,	चुने,	
nauu,	नाऊ,	नाऊ,	
baitul,	बैतुल,	बैतूल,	
dikhla,	दिखला,	दिखला,	
pashtuun,	पश्टुु,	पश्तून,	
samitiyan,	समीतियां,	समितियां,	
abhi,	अभी,	अभी,	
robertson,	रॉबर्टन,	रॉबर्टसन,	
bull,	बुल,	बुल,	
vaigyanik,	वैज्ञनिक,	वैज्ञानिक,	
parvaa,	परवा,	परवा,	
udaanaa,	उड़ना,	उड़ाना,	
virodh,	विरोध,	विरोध,	
naxalwaad,	नकलवााद,	नक्सलवाद,	
paarshadon,	पार्शदों,	पार्षदों,	
sansthita,	संस्थिता,	संस्थिता,	
ghontne,	घोंटने,	घोंटने,	
maryokar,	मरर्योकार,	मयोर्का,	
nagarik,	नागरिक,	नागारिक,	
vaangchuk,	वांगछुक,	वांगचुक,	
kapadi,	कपड़ी,	कापड़ी,	
sharabon,	शर्बों,	शराबों,	
mhagranth,	महगररंथ,	महाग्रंथ,	
nrityashaili,	नृत्यशशलली,	नृत्यशैली,	
opel,	ओपेल,	ओपेल,	
mavey,	मेवे,	मावे,	
darul,	डारुल,	दारूल,	
soharai,	सोहराई,	सोहराई,	
bulaao,	बुलाओ,	बुलाओ,	
lalla,	लाला,	लल्ला,	
abbott,	अबबोट,	एबोट,	
chhagan,	छगन,	छगन,	
alliance,	एलाइंस,	एलियंस,	
bhupsingh,	भूपसिंह,	भूपसिंह,	
julmon,	जल्मों,	जुल्मों,	
anavashyak,	अनावश्यक,	अनावश्यक,	
sarkaron,	सरकारों,	सरकारों,	
kshin,	क्षिण,	क्षीण,	
urff,	उर्फफ,	उर्फ,	
ikarion,	इकारियों,	इकाईयों,	
thahrane,	ठहराने,	ठहरने,	
aarya,	आर्य,	आर्यो,	
aapkaa,	आपका,	आपका,	
shrungar,	श्रृंगर,	शृंगार,	
socar,	सोकार,	सॉकर,	
najib,	नाजिब,	नजीब,	
achchi,	अच्छी,	अच्छी,	
ghatatop,	घटटोो,	घटाटोप,	
sayara,	सायरा,	सायरा,	
piyari,	पियाी,	पियरी,	
langada,	लंगाड़ा,	लंगड़ा,	
race,	रेस,	रेस,	
blosam,	ब्लोसम,	ब्लॉसम,	
ghataya,	घटाया,	घटाया,	
ruktey,	रुकते,	रुकते,	
sapariwar,	सपरविार,	सपरिवार,	
balla,	बल्ला,	बल्ला,	
piyegaa,	पीएगा,	पिएगा,	
failkar,	फैलकर,	फैलकर,	
daka,	डका,	डाका,	
dramen,	ड्रममं,	ड्रामे,	
neat,	नीट,	नीट,	
thirty,	थिर्टी,	थर्टी,	
jean,	जिन,	जीन,	
iso,	आईएसओ,	आइसो,	
bajaru,	बजारू,	बाजारू,	
phalata,	फलता,	फलता,	
faisla,	फ़सलला,	फ़ैसला,	
mnaey,	मनाई,	मनाए,	
damoh,	दमोो,	दमोह,	
superhit,	सुपरीहत,	सुपरहिट,	
dilaye,	दिलाए,	दिलाये,	
hoaf,	होफ,	हॉफ,	
gomukh,	गोमुख,	गौमुख,	
gerome,	गेरोम,	जेरोम,	
phaaph,	फाफ,	फाफ,	
pharase,	फर्से,	फरसे,	
arabab,	अरबब,	अरबाब,	
prashaasanon,	प्रशासनों,	प्रशासनों,	
yudhrat,	युद्रत,	युद्धरत,	
nrityon,	नृत्यों,	नृत्यों,	
obrien,	ओब्रियन,	ओब्रायन,	
ginte,	गिनते,	गिनते,	
charit,	चारित,	चरित,	
methanol,	मैथनॉल,	मेथेनॉल,	
bajana,	बजना,	बजना,	
nauner,	नौनर,	नौनेर,	
ankor,	अंकोर,	अंकोर,	
vishanu,	विषाणु,	विष्णु,	
khanikarmi,	खनिकर्ममी,	खनिकर्म,	
lahlahati,	लहहहाटी,	लहलहाती,	
taiboo,	तैबू,	टैबू,	
rihana,	रिहाना,	रिहाना,	
tir,	तीर,	तीर,	
najariyon,	नज़रियों,	नजरियों,	
vinasht,	विनाश्ट,	विनष्ट,	
plane,	प्लेन,	प्लेन,	
samprabhuta,	संप्रभूता,	संप्रभुता,	
namankanon,	नमानकों,	नामांकनों,	
ankit,	अंकीट,	अंकित,	
fulay,	फुला,	फुलाए,	
keynote,	केनोनट,	कीनोट,	
jajon,	जाज़ों,	जजों,	
lux,	लक्स,	लक्स,	
signals,	सिग्नल्स,	सिगनल्स,	
rovan,	रोवन,	रोवन,	
lurhakate,	लुढ़कते,	लुढ़कते,	
sendha,	सेंधा,	सेंधा,	
pisai,	पिसाई,	पिसाई,	
ashktta,	अष्कतता,	अशक्तता,	
mop,	मोप,	माप,	
rotation,	रोटेशन,	रोटेशन,	
chahunor,	चाहुनोर,	चहुंओर,	
jeetod,	जीतोड,	जीतोड़,	
poojaapaath,	पूजापथठ,	पूजापाठ,	
fransisko,	फ्रांसिस्को,	फ्रांसिस्को,	
kalmen,	कालमें,	कलमें,	
harawal,	हरावल,	हरावल,	
chhura,	छुड़ा,	छुरा,	
chetti,	चेत्टी,	चेट्टी,	
sanskritiyon,	संस्कृतियों,	संस्कृतियों,	
vikramjit,	विक्रमिित,	विक्रमजीत,	
amanati,	अमननती,	अमानती,	
sandarbha,	संदरभा,	संदर्भ,	
jitod,	जितोड़,	जीतोड़,	
jalte,	जलते,	जलते,	
mumba,	मुंबा,	बंबा,	
vanshvad,	वंशवव,	वंशवाद,	
savaal,	सवाल,	सवाल,	
mas,	मस,	मास,	
kut,	कूट,	कूट,	
narayangarh,	नारायंगढ़,	नारायणगढ़,	
janjaagran,	जनजागरण,	जनजागरण,	
khaibar,	खैबर,	ख़ैबर,	
moolar,	मूलर,	मूलर,	
tankaar,	टंकार,	टंकार,	
rishte,	रिश्ते,	रिश्ते,	
samadjiyon,	समद्जियों,	समाधियों,	
bajuon,	बजुओं,	बाजुओं,	
chunar,	चुनार,	चूनर,	
hercules,	हेरक्ल्स,	हरक्यूलिस,	
kabr,	काबर,	कब्र,	
devnar,	देवनार,	देवनार,	
fulae,	फुलाए,	फुलाए,	
mhathir,	महातिर,	महाथिर,	
ludhkate,	लुढ़कते,	लुढ़कते,	
mogali,	मोगली,	मोगली,	
mahagranth,	महगरांथ,	महाग्रंथ,	
kashton,	काष्तों,	कष्टों,	
virechan,	विरेचन,	विरेचन,	
pes,	पेस,	पेस,	
vajood,	वजजद,	वजूद,	
manae,	मनाई,	मनाए,	
hault,	हॉल्ट,	हाल्ट,	
shmadan,	शमदान,	शमादान,	
neko,	नेको,	नेको,	
jood,	जूड,	जूड,	
shriram,	श्रीरम,	श्रीराम,	
dhaak,	ढाक,	धाक,	
brahmalin,	ब्राह्मली,	ब्रह्मलीन,	
bhaunho,	भौन्हों,	भौंहों,	
gowmutra,	गोमूत्र,	गौमूत्र,	
thirke,	थिरके,	थिरके,	
ropaney,	रोपने,	रोपने,	
baramde,	बरमदे,	बरामदे,	
avarnata,	अवर्णता,	अवर्णता,	
sahuuliyata,	सहूलियता,	सहूलियत,	
ubhaara,	उभारा,	उभारा,	
emily,	एमिली,	एमिल,	
nanhe,	नन्हें,	नन्हें,	
dhunai,	धुनाई,	धुनाई,	
brijesh,	ब्रजेश,	बृजेश,	
kaylana,	कायलना,	कायलाना,	
tadipar,	तादीपार,	तड़ीपार,	
roots,	रुट्स,	रूट्स,	
ulahana,	उलहना,	उलाहना,	
pahante,	पहनते,	पहनते,	
phode,	फोडे,	फोड़े,	
ro,	रो,	आरओ,	
raees,	रास,	रईस,	
maid,	मैड,	मैड,	
dilaaye,	दिलाए,	दिलाये,	
trot,	ट्रोट,	ट्रॉट,	
teer,	टीर,	तीर,	
mukhyamantri,	मुख्यमंत्री,	मुख्यमंत्री,	
acchi,	अच्छी,	अच्छी,	
bichhuaa,	बिछुआ,	बिछुआ,	
rasaayanika,	रसायनिका,	रसायनिक,	
isteefe,	इस्तीफ,	इस्तीफे,	
suta,	सूता,	सुता,	
diphtheria,	दिप्रेिरिया,	डिप्थीरिया,	
ali,	एली,	अली,	
vaigyanikata,	वैग्ञानिकता,	वैज्ञानिकता,	
padadhikari,	पदाधिकारी,	पदाधिकारी,	
jhalkati,	झलकती,	झलकती,	
labada,	लाबड़ा,	लबादा,	
semen,	सीमेन,	सेमिन,	
tapuon,	तापूओं,	टापुओं,	
adp,	एडीपी,	एडीपी,	
pratishat,	प्रतिषात,	प्रतिशत,	
samprti,	संपर्ति,	संप्रति,	
prastavon,	प्रस्तावों,	प्रस्तावों,	
ekaki,	इकाकी,	एकाकी,	
lime,	लाइम,	लाइम,	
punter,	पंटर,	पंटर,	
consultant,	कंसलटेंट,	कंसलटेंट,	
recreation,	रिक्रेशन,	रिक्रिएशन,	
avishvasniy,	अविश्वसीनीय,	अविश्वसनीय,	
gujarana,	गुजरना,	गुजारना,	
mahin,	महीन,	महीन,	
manaye,	मनाये,	मनाए,	
bahaav,	बहाव,	बहाव,	
laundry,	लौंड्री,	लॉन्ड्री,	
banva,	बनवा,	बनवा,	
benwar,	बेनवर,	बेंवर,	
jaaunch,	जांच,	जाँच,	
prakriya,	प्रकृरिया,	प्रक्रिया,	
kanishtika,	कनिष्तिका,	कनिष्ठिका,	
lagna,	लगना,	लगना,	
pushkarana,	पुष्करण,	पुष्करणा,	
okalahoma,	ओकालहोमि,	ओकलाहोमा,	
theaters,	थीटर्स,	थियेटर्स,	
scanning,	स्केनिंग,	स्कैनिंग,	
pantar,	पंतरर,	पंटर,	
reshey,	रेशे,	रेशे,	
matsyavatar,	मात्स्वतार,	मत्स्यावतार,	
dalbadl,	डलबादल,	दलबदल,	
suja,	सूजा,	सूजा,	
ilaichi,	इलाइची,	इलाइची,	
labelon,	लेबलों,	लेबलों,	
bekaaboo,	बेकाबू,	बेकाबू,	
nanhein,	नन्हें,	नन्हें,	
gazipur,	गाजीीपुर,	गाजीपुर,	
ashvtth,	अश्वत्थ,	अश्वत्थ,	
sasakon,	सासकों,	शासकों,	
ilayachi,	इलयाची,	इलाइची,	
dhkelate,	ढकेलेे,	धकेलते,	
sfurti,	स्फूर्ति,	स्फूर्ति,	
nauvahan,	नौवाहन,	नौवहन,	
vigyani,	विज्ञानि,	विज्ञानी,	
artha,	आर्थ,	अर्थ,	
wanshwad,	वंशवव,	वंशवाद,	
sate,	सटे,	सते,	
dhkal,	ढकाल,	ढकाल,	
craig,	क्रैज,	क्रेग,	
andha,	अंधा,	अंधा,	
addi,	अडी,	एड्डी,	
chimati,	चिमटी,	चिमटी,	
denevali,	देनेवाली,	देनेवाली,	
idol,	आईडल,	आइडल,	
killi,	किली,	किल्ली,	
ghodi,	घोडी,	घोड़ी,	
gm,	जीएम,	जीएम,	
ishak,	इश्क,	इशाक,	
kapolkalpana,	कापललपप्ना,	कपोलकल्पना,	
sarkarein,	सरक्रें,	सरकारें,	
rukte,	रुकते,	रुकते,	
tasir,	तसीीर,	तासीर,	
lanset,	लांसेट,	लैंसेट,	
badhayi,	बढ़ाई,	बढ़ायी,	
nikalani,	निकालनी,	निकालनी,	
engineer,	इंजीनियर,	इंजिनियर,	
upakhyanon,	उपाख्यानों,	उपाख्यानों,	
advait,	अदववैत,	अद्वैत,	
ladaiyon,	लड़ाइयों,	लड़ाईयों,	
pathshalayen,	पाठशालाएं,	पाठशालाएं,	
valkan,	वाल्कन,	वल्कन,	
suneyga,	सुनेएगा,	सुनेगा,	
bagabani,	बागबनी,	बागबानी,	
tennis,	टेनिस,	टैनिस,	
sadanand,	सद्दंद,	सदानंद,	
putliyon,	पुटलियों,	पुतलियों,	
sanskar,	संस्कर,	संस्कार,	
zawar,	जावर,	जावर,	
fulaaye,	फुलाए,	फुलाए,	
vaishnodevi,	वैश्नोदीवी,	वैष्णोदेवी,	
karam,	कराम,	करम,	
mhavidyan,	महाविद्ञान,	महाविज्ञान,	
hafate,	हफाते,	हांफते,	
khajarana,	खजराा,	खजराना,	
sanyukt,	सानयुक्त,	संयुक्त,	
divy,	दिवी,	दिव्य,	
amavasya,	अमावस्य,	अमावस्या,	
mhapauron,	महापोपों,	महापौरों,	
falitarth,	फलीीार्थ,	फलितार्थ,	
kacche,	कच्चे,	कच्चे,	
talabgaar,	तलबबगार,	तलबगार,	
ninties,	निंटीज,	नाइनटीज,	
masyendranath,	मस्ेेंद्राथथ,	मत्स्येंद्रनाथ,	
tarkon,	तर्कों,	तर्कों,	
charge,	चार्ज,	चार्ज,	
yatraen,	यात्राएं,	यात्राएं,	
saptkraanti,	सप्तक्रांति,	सप्तक्रांति,	
nilaabh,	नीलाभ,	नीलाभ,	
telon,	टेलों,	तेलों,	
heroes,	हीरोज,	हीरोज,	
dikhai,	दिखाई,	दिखार्इ,	
lalkarata,	लाकररता,	ललकारता,	
antony,	अंटोनी,	एंटोनी,	
shabana,	शबाना,	शबाना,	
phurti,	फुर्ती,	फूर्ति,	
chaudahavan,	चौदहवाह,	चौदहवां,	
rayan,	रायन,	रयान,	
narnaari,	नारनारी,	नरनारी,	
amadani,	अमदनी,	आमदनी,	
grenite,	ग्रेनिट,	ग्रेनाइट,	
bhabhut,	भभूत,	भभूत,	
barah,	बारह,	बारह,	
population,	पॉपुलेशन,	पापुलेशन,	
asset,	एसेट,	असेट,	
yarushalem,	यरुष्मे,	यरूशलेम,	
chhupakar,	छुपाकर,	छुपकर,	
mithilanchal,	मिथिलालल,	मिथिलांचल,	
wasting,	वास्टिंग,	वेस्टिंग,	
mam,	माम,	मम,	
mauritious,	मॉरीशस,	मॉरिशस,	
vimarshon,	विमर्षों,	विमर्शों,	
punargathan,	पुनर्गठान,	पुनर्गठन,	
kamaate,	कमाते,	कमाते,	
karchhana,	कर्चना,	करछना,	
dhandhaanya,	धनधान्य,	धनधान्य,	
tarashe,	तररेश,	तराशे,	
ushma,	उष्मा,	ऊष्मा,	
badhata,	बढ़ता,	बढ़ाता,	
khat,	खात,	खत,	
rasyanik,	रस्यनिक,	रसायनिक,	
rental,	रेंटल,	रेंटल,	
vayna,	वायना,	वायना,	
bhukhi,	भुखी,	भूखी,	
surinaam,	सुरीनाम,	सूरीनाम,	
banthia,	बांथिया,	बांठिया,	
pushkarna,	पुष्कर्ण,	पुष्करणा,	
mathe,	मथेे,	माथे,	
bago,	बागो,	बागो,	
vanon,	वनों,	वाणों,	
istife,	इस्टाइफ,	इस्तीफे,	
jaat,	जात,	जात,	
kaav,	काव,	काव,	
phadphadata,	फद्दावाता,	फड़फड़ाता,	
andheri,	अंधेरी,	अंधेरी,	
aasteen,	आस्तीन,	आस्तीन,	
sanskrit,	संस्कृत,	संस्कृत,	
brajesh,	ब्रजेश,	ब्रजेश,	
hundiya,	हुंडिया,	हंडिया,	
bauni,	बौनी,	बौनी,	
amrohi,	अमरोही,	अमरोही,	
phatne,	फटने,	फटने,	
sugmta,	सूगम्ता,	सुगमता,	
tip,	टीप,	टिप,	
proto,	प्रोटो,	प्रोटो,	
palmonari,	पाल्मोररी,	पल्मोनरी,	
jayke,	जायके,	जायके,	
bhadakaaya,	भड़काया,	भड़काया,	
hamaal,	हमाल,	हमाल,	
nagrik,	नागरिक,	नागारिक,	
nidhan,	निधन,	निधान,	
ishaaq,	इशाक,	इशाक,	
sargi,	सार्गी,	सरगी,	
plan,	प्लैन,	प्लेन,	
bhadakaya,	भड़काया,	भड़काया,	
visheshan,	विशेषन,	विशेषण,	
saturday,	सतुर्दय,	सेटरडे,	
goswami,	गोस्वामी,	गोस्वामी,	
masur,	मसूर,	मसूर,	
registered,	रेजि्टेेड,	रजिस्टर्ड,	
wedding,	वेडिंग,	वेडिंग,	
bandage,	बंदगे,	बैंडेज,	
nitrous,	नाइट्रॉज,	नाइट्रस,	
destination,	डेस्टिनेशन,	डेस्टिनेशन,	
ehsas,	एहसास,	एहसास,	
dikhaaiye,	दिखाइए,	दिखाइये,	
tse,	त्स,	त्से,	
shaasaka,	शासका,	शासक,	
lumding,	लमडिंग,	लुमडिंग,	
baithate,	बैठते,	बैठते,	
kalighat,	कालिघाट,	कालीघाट,	
tyauharon,	त्याहारों,	त्यौहारों,	
avrutiyon,	आवृत्तियों,	आवृत्तियों,	
praneet,	प्रणीत,	प्रनीत,	
nun,	नन,	नून,	
aata,	आता,	आटा,	
nabz,	नब्ज,	नब्ज़,	
paramparikta,	पारंपरिकता,	पारंपरिकता,	
tapakti,	तपकती,	टपकती,	
janhaani,	जनहानी,	जनहानि,	
roomani,	रूमानी,	रुमानी,	
doranda,	डोरांदा,	डोरंडा,	
vitthal,	वित्थल,	विठ्ठल,	
bala,	बला,	बाला,	
mundva,	मुंदवा,	मुंडवा,	
kiya,	किया,	किया,	
equador,	एक्वूडर,	इक्वाडोर,	
gammat,	गम्मत,	गम्मत,	
banbi,	बांबी,	बांबी,	
gae,	गा,	गए,	
radhe,	राढे,	राधे,	
panpana,	पनपनन,	पनपना,	
parishadiya,	परिशदीय,	परिषदीय,	
brock,	ब्रॉक,	ब्रोक,	
varnit,	वर््तित,	वर्णित,	
trouble,	ट्रबल,	ट्रेबल,	
alasi,	अलसी,	आलसी,	
jivan,	जीवन,	जीवन,	
putla,	पुटला,	पुतला,	
crick,	क्रिक,	क्रिक,	
attahasa,	अत्ताहासा,	अट्टहास,	
pravati,	प्रवाती,	प्रवत्ति,	
maurya,	मौर्य,	मौर्यों,	
valve,	वाल्वे,	वाल्व,	
maheman,	महमैैन,	मेहमान,	
sev,	सेव,	सेव,	
aalochakon,	आलोचकों,	आलोचकों,	
harana,	हराना,	हारना,	
chhinky,	छींके,	छींके,	
maina,	मैना,	मैना,	
sagarika,	सागरीका,	सागरिका,	
feeder,	फीडर,	फीडर,	
bhugata,	भुगता,	भुगता,	
jhankana,	झंकाना,	झांकना,	
bhulataa,	भुलता,	भूलता,	
biswa,	बिसवा,	बिस्वा,	
badam,	बददम,	बदाम,	
pathyakramon,	पाठयक्रमों,	पाठ्यक्रमों,	
chhe,	छे,	छै,	
chidchidapan,	चिड़चिड़ापन,	चिडचिडापन,	
anyaay,	अन्याय,	अन्याय,	
jamaanaa,	जमाना,	ज़माना,	
chhink,	छींक,	छींक,	
phus,	फुस,	फूस,	
sensing,	सेंसिंग,	सेंसिंग,	
idle,	इडल,	आइडल,	
straws,	स्ट्रॉस,	स्ट्रास,	
matpatron,	मातपत्ररों,	मतपत्रों,	
adwait,	अदववैत,	अद्वैत,	
oklahoma,	ओकोलहोमि,	ओक्लाहोमा,	
bagh,	बाघ,	बाग,	
katra,	काररा,	कटरा,	
rambharose,	रामभरोस,	रामभरोसे,	
failaaiye,	फैलाईय,	फैलाइए,	
ibija,	इबीजा,	इबीजा,	
cps,	सीपीएस,	सीपीएस,	
aviral,	अविराल,	अविरल,	
adad,	अदाद,	अदद,	
nichala,	निचला,	निचला,	
jha,	झा,	झ,	
samadhan,	समाधान,	समाधान,	
sandarbhon,	संदरभोों,	संदर्भों,	
piki,	पीकी,	पिकी,	
khariya,	खरिराय,	खरिया,	
nelsan,	नेलसन,	नेल्सन,	
jaunch,	जांच,	जाँच,	
thitron,	थित्रों,	थियेटरों,	
bhaskar,	भस्कर,	भास्कर,	
bahavalpur,	बहववलपुर,	बहावलपुर,	
route,	राउट,	रूट,	
mejabani,	मेजबनी,	मेजबानी,	
apvtrit,	अपवृत्तित,	अपवर्तित,	
juraab,	जुराब,	जुराब,	
bhabhoot,	भभूतू,	भभूत,	
udaane,	उड़ने,	उड़ाने,	
dukhiyon,	दुखियों,	दुखियों,	
mango,	मांगो,	मांगो,	
asamany,	असामान्य,	असमान्य,	
panter,	पंटर,	पंटर,	
neechaaee,	नीचाई,	नीचाई,	
pidiyaa,	पीढ़िया,	पीडिया,	
belinda,	बेलिंदा,	बेलिंडा,	
biji,	बीजी,	बिजी,	
sapraman,	सप्रमान,	सप्रमाण,	
padamawati,	पदममववती,	पदमावती,	
elaichi,	इलेची,	इलाइची,	
bhraantiyon,	भ्रांतियों,	भ्रांतियों,	
nandanvan,	नंदंवन,	नंदनवन,	
aryo,	अर्यो,	आर्यो,	
naksali,	नकसाली,	नक्सली,	
dam,	डैम,	डम,	
pendulum,	पेंडुलुम,	पेंडुलम,	
charon,	चारों,	चारों,	
classen,	क्लेसन,	क्लासें,	
bapa,	बापा,	बापा,	
slider,	स्लाइडर,	स्लाइडर,	
sarkaren,	सरकरें,	सरकारें,	
chatushkoniya,	चतुत्ुकीीय,	चतुष्कोणीय,	
nectar,	नेक्टर,	नेक्टर,	
paneer,	पननीर,	पनीर,	
dabolim,	डबोलिम,	डाबोलिम,	
pehni,	पहनी,	पहनी,	
udakishuganj,	उद्किशुंज,	उदाकिशुनगंज,	
puraane,	पुराने,	पुराने,	
cric,	क्रिक,	क्रिक,	
talve,	तलवे,	तलवे,	
ladte,	लाड़ते,	लड़ते,	
amitao,	अमिताओ,	अमिताव,	
chhavi,	छावी,	छवी,	
short,	शोर्ट,	शोर्ट,	
jgayegaa,	जगाएगा,	जगाएगा,	
viresh,	विरेष,	वीरेश,	
iter,	आइटर,	ईटर,	
jajmau,	जजमाऊ,	जाजमऊ,	
lalpur,	लालपुर,	लालपुर,	
manmarji,	मनममररजी,	मनमर्जी,	
mahajan,	महजजन,	महाजन,	
ahirauli,	अहिरौली,	अहिरौली,	
chadaron,	चादारों,	चादरों,	
sambhalne,	संभालने,	संभालने,	
conjunction,	कन्क्शशन,	कंजंक्शन,	
mukartey,	मुकर्ते,	मुकरते,	
pedia,	पेड़िया,	पीडिया,	
gin,	गिन,	जिन,	
ranjkatha,	रंजकाा,	रंजकता,	
nineteez,	निनेटेज,	नाइनटीज,	
swap,	स्वैप,	स्वैप,	
virodhabhason,	विरोदाभासों,	विरोधाभासों,	
sandli,	सांडली,	संदली,	
bachati,	बचाती,	बचती,	
retweet,	रिटवीत,	रीट्वीट,	
vaadiyon,	वादियों,	वादियों,	
prapaaton,	प्राातों,	प्रपातों,	
ladki,	लड़की,	लड़की,	
vipro,	विप्रो,	विप्रो,	
letakar,	लेटाकार,	लेटकर,	
snikarse,	स्निकार्स,	स्नीकर्स,	
kranj,	क्रजं,	करंज,	
squash,	स्क्वाश,	स्क्वाश,	
erica,	एरिका,	एरिका,	
medical,	मेडिकल,	मेडीकल,	
bodraa,	बोडरा,	बोदरा,	
kmere,	क्मेर,	कमेरे,	
satluj,	सतलूज,	सतलुज,	
ghataayaa,	घटाया,	घटाया,	
vaimanasy,	वैमानस्य,	वैमनस्य,	
andrabee,	अंदराबी,	अंद्राबी,	
makhdumpur,	मखखमपुर,	मखदुमपुर,	
slash,	स्लैश,	स्लैश,	
rigal,	रिगल,	रीगल,	
nabj,	नब्ज,	नब्ज़,	
jagriti,	जाग्री,	जागृति,	
yashpaal,	यशस्लाल,	यशपाल,	
aawajon,	आवाजों,	आवाज़ों,	
rasad,	रसाद,	रसद,	
saajsajja,	साजसाजज,	साजसज्जा,	
jaanam,	जानम,	जानम,	
atake,	अटके,	अटके,	
ti,	ती,	ती,	
dungerpur,	दंगरपुर,	डूंगरपुर,	
alankaar,	अलंकार,	अलंकार,	
kiratpur,	किरतपुर,	कीरतपुर,	
deshkaal,	देशकाल,	देशकाल,	
bipin,	बीपिन,	बिपिन,	
jiya,	जिया,	जिया,	
westing,	वेस्टिंग,	वेस्टिंग,	
singhde,	सिंहड़,	सिंघाड़े,	
favvare,	फववायर,	फव्वारे,	
baapa,	बापा,	बापा,	
chhetthari,	छेत्थारी,	छेत्री,	
kurvi,	कुर्वी,	कर्वी,	
man,	मान,	मैन,	
khyber,	खिबरर,	ख़ैबर,	
bhavishya,	भविष्य,	भविष्य,	
ditaa,	दिता,	दिता,	
zubair,	ज़ुबैर,	जुबेर,	
brigadier,	ब्रिगेडियर,	ब्रिगेडियर,	
galaxion,	गैल्क्सन,	गैलेक्सियों,	
aawaazen,	आवाजें,	आवाज़ें,	
sheling,	शेलिंग,	शेलिंग,	
ret,	रेट,	रेत,	
mathey,	मथ्े,	माथे,	
vaisley,	वैसली,	वेस्ले,	
khanik,	खनिक,	खनिक,	
prema,	प्रेमा,	प्रेमा,	
chadron,	चद्रों,	चादरों,	
package,	पैकेज,	पैकेज,	
sahab,	सहाब,	साहब,	
bhugta,	भुगता,	भुगता,	
hymen,	हामेन,	हाइमन,	
jerome,	जेरोम,	जेरोम,	
theatrs,	थीटर्स,	थियेटर्स,	
aaraam,	आराम,	आराम,	
sisva,	सिस्वा,	सिसवा,	
urgent,	उर्जेंट,	अर्जेंट,	
madhuara,	मधुवरा,	मढ़ौरा,	
bahulya,	बहुल्य,	बाहुल्य,	
parikshaayein,	परीक्षाएं,	परीक्षाएं,	
bandhan,	बांधन,	बंधान,	
hamla,	हमला,	हमला,	
vitthal,	वित्थल,	विट्ठल,	
soma,	सोमा,	सोमा,	
tapmanon,	तप्मनों,	तापमानों,	
neelaabh,	नीलाभ,	नीलाभ,	
larry,	लैरी,	लैरी,	
tarafa,	तरफा,	तरफा,	
jalesar,	जालेसर,	जलेसर,	
verbal,	वर्बल,	वर्बल,	
pehno,	पहनो,	पहनो,	
tuning,	टूनिंग,	ट्यूनिंग,	
chrom,	क्रोम,	क्रोम,	
khachakhach,	खचचाच,	खचाखच,	
vishwasaniyata,	विश्वसनीतता,	विश्वसनीयता,	
matsyavtar,	मत्स्यवतरर,	मत्स्यावतार,	
maang,	मांग,	मांग,	
hemvati,	हेमवती,	हेमवती,	
avsthayen,	अवस्थाएं,	अवस्थाएं,	
chhuptaa,	छुप्ा,	छुपता,	
kanaal,	कणाल,	कनाल,	
taahi,	ताही,	ताहि,	
nazarandaaj,	नज़रंदाज़,	नजरंदाज,	
urf,	उर्फ,	उर्फ,	
manchon,	मांचों,	मंचों,	
tikamgarh,	तीकामगढ़,	टीकमगढ़,	
darjanon,	दरजानों,	दर्जनों,	
sdueep,	स्द्पीप,	सुदीप,	
dredger,	ड्रेजर,	ड्रेजर,	
kiliyan,	किलियां,	किलियन,	
kamatar,	कमातर,	कमतर,	
parishadon,	परिशादों,	परिषदों,	
aadheen,	आधीन,	आधीन,	
punchang,	पंचांग,	पंचांग,	
taapti,	ताप्ति,	ताप्ती,	
anyaya,	अन्याय,	अन्याय,	
prahlaad,	प्रह्लाद,	प्रहलाद,	
yarooshaleim,	यरूष्मेम,	यरूशलेम,	
chaudhavan,	चौधवान,	चौदहवां,	
murjha,	मुर्झ,	मुर्झा,	
kanishthika,	कनिष्ठिता,	कनिष्ठिका,	
robertsan,	रॉबर्टन,	रॉबर्टसन,	
dayitv,	दययत्व,	दायित्व,	
dikhaee,	दिखाई,	दिखाईं,	
aadhaarit,	आधारित,	आधारित,	
ashaktataa,	अशक्तता,	अशक्तता,	
paradhin,	पराधीन,	पराधीन,	
survin,	सुर्वीं,	सुरवीन,	
propellent,	प्रोपललेंट,	प्रोपेलेंट,	
manjila,	मंजिला,	मंजिला,	
purvabhas,	पूर्वभास,	पूर्वाभास,	
bella,	बेल्,	बैला,	
ghot,	घोट,	घोट,	
retreate,	रेट्रेट,	रीट्वीट,	
saayn,	सायन,	सायं,	
fabti,	फबती,	फब्ती,	
mular,	मूलर,	मूलर,	
ishaara,	इशारा,	इशारा,	
samanjasy,	समांजासी,	सामंजस्य,	
martha,	मार्था,	मार्था,	
triya,	त्रिया,	त्रिया,	
eksaath,	एकसाठ,	एकसाथ,	
pulam,	पुलम,	पुलम,	
jalbhraav,	जलभ्रवव,	जलभराव,	
marmar,	मर्मरर,	मरमर,	
sukhati,	सूखती,	सूखती,	
maryadaon,	मररयाााओं,	मर्यादाओं,	
lapetne,	लेपटन,	लपेटने,	
dubna,	डूबना,	डूबना,	
shaantikaal,	शांतिकाल,	शांतिकाल,	
nagin,	नागीन,	नागिन,	
gaytri,	गाय्तरी,	गायत्री,	
nigger,	निग्गर,	निगर,	
matsyendranath,	मा्ससेंद्रनाथ,	मत्स्येंद्रनाथ,	
dastaanaa,	दस्ताना,	दस्ताना,	
nishchal,	निश्चाल,	निश्चल,	
talawon,	तलवां,	तलवों,	
rahmat,	रहमतत,	रहमत,	
franciska,	फ्रैंसिस्का,	फ्रांसिस्का,	
mehamaan,	मेहमान,	मेहमान,	
phogat,	फोगत,	फोगाट,	
tarch,	तार्च,	टार्च,	
nemo,	नेमो,	नेमो,	
chitthi,	चित्ती,	चिठ्ठी,	
chee,	ची,	ची,	
alonso,	एलोंस,	अलोंसो,	
badhati,	बढ़ती,	बढ़ाती,	
naivedh,	नैवेध,	नैवेद्य,	
padhata,	पढ़ता,	पढ़ाता,	
ishita,	इशिता,	इशिता,	
prashansanon,	प्रशंसनों,	प्रशासनों,	
megapixel,	मैगेजिपल,	मेगापिक्सल,	
chandrabali,	चंद्रबाली,	चंद्रबली,	
juye,	जुए,	जुए,	
pardesiyon,	परदेशियों,	परदेसियों,	
usmein,	उसमें,	उसमें,	
junun,	जुनून,	जुनून,	
chhinke,	छींके,	छींके,	
samjhungaa,	समझौंगा,	समझूंगा,	
two,	ट्वू,	टु,	
tarashay,	तरराशय,	तराशे,	
kakkad,	कक्कड़,	कक्कड़,	
tughlakabad,	तुल्लकाबाद,	तुगलकाबाद,	
singhade,	सिंहड़े,	सिंघाड़े,	
sapane,	सपने,	सपने,	
kural,	कुरल,	कुराल,	
aaram,	आरम,	आराम,	
bhariy,	भारिय,	भारीय,	
koot,	कूट,	कूट,	
aarya,	आर्य,	आर्य,	
wayna,	वायना,	वायना,	
rate,	रेट,	रेट,	
dhandhon,	ढंधों,	धंधों,	
transfer,	ट्रांसफर,	ट्रान्सफर,	
registani,	रेजि््तनी,	रेगिस्तानी,	
parikshaen,	परीक्षाएं,	परीक्षाएं,	
uski,	उसकी,	उसकी,	
lidaron,	लिडारों,	लीडरों,	
junagadh,	जूनागढ़,	जूनागढ,	
daah,	दाह,	दाह,	
paim,	पैमम,	पैम,	
bilai,	बिलाई,	बिलाई,	
brok,	ब्रॉक,	ब्रोक,	
aaryika,	आर्यिका,	आर्यिका,	
lahalhati,	लहलहाी,	लहलहाती,	
maulvidon,	मौलविदों,	मौलवियों,	
items,	इटेस्स,	आइटम्स,	
mange,	मागे,	मांगे,	
dhairyawan,	धैर्यवान,	धैर्यवान,	
bawara,	बावरा,	बावरा,	
dhairyavaan,	धैर्यवान,	धैर्यवान,	
kalmein,	कालमें,	कलमें,	
bhurbhura,	भुरभुरा,	भुरभुरा,	
mahipal,	महिपाल,	महिपाल,	
abhishap,	अभिष्ष,	अभिशाप,	
chan,	चान,	चान,	
sikar,	सिकार,	सीकर,	
fislaa,	फिसला,	फिसला,	
jubair,	जुबैर,	जुबेर,	
asthetic,	एस्थेटिक,	एस्थेटिक,	
baitool,	बैटूल,	बैतूल,	
auchitya,	औचितिय,	औचित्य,	
kajoo,	काजू,	काजू,	
kaaji,	काजी,	काजी,	
virajati,	विराजति,	विराजती,	
aalsi,	आलसी,	आलसी,	
shrankhala,	श्रंंल,	श्रंखला,	
melanin,	मेलेनिन,	मेलानिन,	
mahalon,	महालों,	महलों,	
sohrai,	सोहराई,	सोहराई,	
ginate,	गिनते,	गिनते,	
prahasan,	प्रहससन,	प्रहसन,	
sataane,	सताने,	सताने,	
tantra,	तां््रा,	तंत्र,	
landara,	लंदारा,	लंगड़ा,	
rajasva,	राजसवा,	राजस्व,	
gazi,	गाजी,	गाज़ी,	
junoon,	जुनून,	जुनून,	
jhil,	झिल,	झील,	
khinchakar,	खींचकर,	खिंचकर,	
niki,	निकी,	निकी,	
vyavahargat,	व्यवहार्ात,	व्यवहारगत,	
khastaur,	खासतौर,	ख़ासतौर,	
ahyan,	अह्ञान,	आह्नान,	
spma,	स्प्मा,	सोमा,	
granthiyon,	ग्रंथियों,	ग्रंथियों,	
solitaire,	सोल्टाइर,	सोलिटेयर,	
paraadheen,	पराधीन,	पराधीन,	
pengolin,	पैंगोलिन,	पैंगोलिन,	
siwan,	सिवन,	सिवान,	
isayiyon,	ईसाईयों,	ईसाइयों,	
drager,	ड्रेगर,	ड्रेजर,	
nageene,	नागीने,	नगीने,	
shaharwasiyon,	शहरवासियों,	शहरवासियों,	
pharse,	फर्स,	फरसे,	
vigyaani,	विज्ञानी,	विज्ञानी,	
mimicry,	मिमिक्री,	मिमिक्री,	
rojvelt,	रॉज़वेल्ट,	रुजवेल्ट,	
chhetthri,	छेत्तरी,	छेत्री,	
lootmaar,	लूटमार,	लूटमार,	
amy,	एम्य,	एमी,	
sriram,	श्रीराम,	श्रीराम,	
bichhua,	बिछुआ,	बिछुआ,	
danpati,	दानपति,	दंपति,	
nawanagar,	नवननगर,	नवानगर,	
vyagra,	व्याग्र,	व्यग्र,	
pushpon,	पुष्पों,	पुष्पों,	
sukhakar,	सुखाकर,	सूखाकर,	
jankaron,	जानकरों,	जानकारों,	
vikalpon,	विकल्पों,	विकल्पों,	
gyatavya,	ज्ञातव्य,	ज्ञातव्य,	
kile,	कीले,	क़िले,	
testing,	टेस्टिंग,	टेस्टिंग,	
teekamgarh,	तीकामगढ़,	टीकमगढ़,	
sarhind,	सरहंं,	सरहिंद,	
reasonal,	रिशनन,	रीजनल,	
spf,	एसपीएफ,	एसपीएफ,	
simate,	सीमतते,	सिमटे,	
vashikaran,	वाष्पीकरण,	वशीकरण,	
manjilen,	मानजीलें,	मंजिलें,	
arya,	आर्य,	आर्यों,	
shat,	क्षतट,	षट्,	
bhairo,	भैरो,	भैरो,	
mame,	माम,	मामे,	
pierson,	पीर्सन,	पियरसन,	
bazaru,	बजारू,	बाजारू,	
sabhayen,	सभाएं,	सभाएं,	
batlaaye,	बतलाए,	बतलाए,	
aatmayen,	आत्मेें,	आत्माएं,	
nana,	नाना,	नना,	
lakiron,	लकीरोों,	लकीरों,	
jimme,	जिम्म,	जिम्मे,	
dhatana,	ढटना,	धटना,	
urvarata,	उर्वारता,	उर्वरता,	
vipra,	विप्र,	विप्रा,	
nineties,	नाइटीटीज,	नाइनटीज,	
bandhuon,	बंधुओं,	बंधुओं,	
naksalwaad,	नकसलवााद,	नक्सलवाद,	
jaljale,	जलजलाे,	ज़लज़ले,	
lagataar,	लगातार,	लागातार,	
gidgidate,	गिड्गिगते,	गिड़गिड़ाते,	
contemporary,	कंटेन्ररी,	कंटेम्पररी,	
udakishunganj,	उद्किशुंगज,	उदाकिशुनगंज,	
aagaman,	आगमन,	आगमन,	
desai,	देसाई,	देसाई,	
mardanagi,	मार्दागगी,	मर्दानगी,	
baksi,	बक्सी,	बक्सी,	
melaanin,	मेलानिन,	मेलानिन,	
parva,	परवा,	परवा,	
kasimabad,	कासीमाबाद,	कासिमाबाद,	
calling,	कॉलिंग,	कोलिंग,	
gajipur,	गाजीीपुर,	गाजीपुर,	
tirthatan,	तीर्थथतन,	तीर्थाटन,	
made,	मेड,	मैड,	
vaishakh,	वैशाख,	वैशाख,	
ganguly,	गंगुलल,	गांगुली,	
mad,	माद,	मैड,	
laegi,	लाएगी,	लाएगी,	
pace,	पेस,	पेस,	
raj,	रजज़,	राज,	
avsthaen,	अवस्थाएं,	अवस्थाएं,	
hippo,	हिप्पो,	हिप्पो,	
doonarpur,	दूनरपुर,	डूंगरपुर,	
duvidhaen,	दुविधाएं,	दुविधाएं,	
haanfte,	हानफते,	हांफते,	
radical,	रेडिकल,	रैडिकल,	
funda,	फुंडा,	फंडा,	
muth,	मूथ,	मूठ,	
avasthaayen,	अवस्थाएं,	अवस्थाएं,	
shumaali,	शुमाली,	शुमाली,	
taajaa,	ताजा,	ताजा,	
ethan,	ईथन,	ऐठन,	
jaghaega,	जगाएगा,	जगाएगा,	
gajra,	गज़रा,	गजरा,	
baldvin,	बलल्वीं,	बाल्डविन,	
aapdayein,	आपदायें,	आपदाएं,	
navvadhu,	नवववध,	नववधू,	
gopichand,	गोपीचंद,	गोपीचंद,	
sudhargrih,	सुधारगररहह,	सुधारगृह,	
banu,	बानु,	बनू,	
routine,	राउटीन,	रूटिंग,	
sapate,	सपते,	सपाटे,	
kaalpi,	कालपी,	कालपी,	
lendal,	लेंडल,	लेंडल,	
maisore,	मैसोर,	मैसोर,	
bharani,	भरनी,	भरनी,	
aryama,	आर्यमा,	अर्यमा,	
padmawati,	पद्मावती,	पदमावती,	
kaushal,	कौशल,	कौशल,	
manzila,	मंजिला,	मंजिला,	
aster,	एस्टर,	एस्टर,	
baagiyon,	बागियों,	बागियों,	
gadkar,	गड़कर,	गडकर,	
ralaud,	रालौड,	रालोद,	
jhuthla,	झुठला,	झुठला,	
athak,	अथक,	अथक,	
kasida,	कसीदा,	कसीदा,	
ladaai,	लड़ाई,	लड़ाई,	
dewey,	देवे,	डेवी,	
lega,	लेगा,	लेगा,	
vruton,	वृतों,	वृत्तों,	
vidyaon,	विद्याओं,	विद्याओं,	
kamate,	कमाते,	कमाते,	
pardaa,	परदा,	पर्दा,	
daddy,	डै््ी,	डैडी,	
upadraviyon,	उपद्रवियों,	उपद्रवियों,	
ankon,	अंकों,	अंकों,	
merraige,	मैरेज,	मैरेज,	
vartmaan,	वार्तमान,	वर्तमान,	
gouchar,	गौचार,	गोचर,	
farmic,	फर्ममिक,	फार्मिक,	
jewellers,	ज्वलल्स,	ज्वेलर्स,	
shujaat,	शुजात,	शुजात,	
shrunkhlaon,	शृंखलाओं,	श्रंखलाओं,	
badli,	बदली,	बदली,	
tarkvad,	तर्कवाद,	तर्कवाद,	
aadaan,	आदान,	आदान,	
jatatee,	जताती,	जताती,	
nights,	नाइट्स,	नाइट्रस,	
dikhai,	दिखाई,	दिखायी,	
nna,	नन,	नना,	
nubiya,	नूबिया,	नूबिया,	
uthakar,	उठाकर,	उठाकर,	
stithi,	स्तिथि,	स्तिथि,	
jassee,	जस्सी,	जस्सी,	
mufalisi,	मुफालिसी,	मुफलिसी,	
karyrat,	कार्यात,	कार्यरत,	
quebec,	क्वूक्स,	क्यूबेक,	
jain,	जैन,	जैन,	
dhokebaaj,	धोखेबाज,	धोखेबाज,	
dolne,	डॉलन,	डोलने,	
chillane,	चिलनने,	चिल्लाने,	
farm,	फर्म,	फार्म,	
kavvali,	क़व्वाली,	कव्वाली,	
version,	वर्जनन,	वर्शन,	
ishaaraa,	इशारा,	इशारा,	
rapping,	रैपिंग,	रैपिंग,	
cheh,	चीह,	छह,	
eon,	इयोन,	इआन,	
bagali,	बगली,	बागली,	
urwarakon,	उर्वारों,	उर्वरकों,	
matrix,	मेट्रिक्स,	मैट्रिक्स,	
jalbharav,	जलभभरव,	जलभराव,	
robin,	रॉबिन,	रोबिन,	
sakar,	साकार,	सॉकर,	
nikhar,	निखर,	निखर,	
jamana,	जममना,	ज़माना,	
pradarshan,	प्रदर्शन,	प्रर्दशन,	
uzbek,	उज्ेक,	उज़्बेक,	
slice,	स्लाइस,	स्लाइस,	
ralhan,	राल्न,	रल्हन,	
khaatey,	खाते,	खाते,	
jhilon,	झिलों,	झीलों,	
theateron,	थियटरों,	थियेटरों,	
baawaraa,	बावऱा,	बावरा,	
rajman,	राजमान,	राजमां,	
lagega,	लगेगा,	लगेगा,	
fansi,	फांसी,	फांसी,	
pihani,	पिहनी,	पिहानी,	
flin,	फ्लिन,	फ्लिन,	
yaatna,	याटना,	यातना,	
naamdhari,	नामधारी,	नामधारी,	
sk,	एससे,	एसके,	
racing,	रेसिंग,	रेसिंग,	
convention,	कन्वेशन,	कनवेंशन,	
denewaali,	देनेवाली,	देनेवाली,	
sarguja,	सरगुजा,	सरगुजा,	
chalit,	चलित,	चालित,	
dakhil,	दखख़िल,	दाखिल,	
failaiya,	फैलैईया,	फैलाइए,	
aabantit,	आबंतित,	आबंटित,	
mejbaani,	मेजबानी,	मेज़बानी,	
nihalaani,	निहालनी,	निहलानी,	
udaan,	उड़न,	उड़ान,	
khaaskar,	खासकर,	ख़ासकर,	
gujara,	गुजरा,	गुजारा,	
saltanat,	सल्टानत,	सल्तनत,	
jay,	जाय,	जय,	
sukhti,	सूखती,	सूखती,	
mave,	मेवे,	मावे,	
rahegi,	रहेगी,	रहेगी,	
kathor,	काठोर,	कठोर,	
bhara,	भरा,	भरा,	
punjab,	पूंजाब,	पंजाब,	
bediyan,	बेदियां,	बेड़ियां,	
khurasan,	खुरससन,	खुरासान,	
scala,	स्काला,	स्काला,	
fringe,	फ्रिंग,	फ्रिंज,	
pigmentation,	पिज्मेटेशन,	पिगमेंटेशन,	
besahaaraa,	बेसहरर,	बेसहारा,	
shaishav,	शैषाव,	शैशव,	
weronika,	वेरोणिका,	वेरोनिका,	
ekatthi,	इकाट्ठी,	इकठ्ठी,	
mahasinh,	महासिंह,	महासिंह,	
beem,	बीम,	बीम,	
tadipaar,	तादीपार,	तड़ीपार,	
rodrigo,	रोड्रिगो,	रोड्रिगो,	
shitij,	क्षीतिज,	क्षितिज,	
munnu,	मुन्नू,	मुन्नू,	
rupi,	रूपी,	रूपी,	
sthitiyan,	स्थितियां,	स्थितियां,	
pitamah,	पीतामाह,	पितामह,	
uthne,	उठने,	उठने,	
jayalalitaa,	जयलालिता,	जयललिता,	
deonar,	देनार,	देवनार,	
nihalchand,	निहलचंद,	निहालचंद,	
lairy,	लैरी,	लैरी,	
vasearche,	वेसर्च,	वर्साचे,	
rabha,	रभा,	राभा,	
wirerless,	वायरलेस,	वायरलेस,	
baramad,	बरामद,	बरामद,	
samjhoonga,	समझूंगा,	समझूंगा,	
likhakar,	लिखाकर,	लिखकर,	
balty,	बाल्टी,	बाल्टी,	
naushad,	नौषद,	नौशाद,	
rasayanon,	रसायों,	रसायनों,	
jarakh,	जरख,	जरख,	
maryaadaa,	मररयादा,	मर्यादा,	
lutf,	लुट,	लुत्फ,	
yatna,	यतना,	यत्न,	
bhaunhon,	भौनहों,	भौंहों,	
niya,	निया,	निया,	
ramtek,	रममतेक,	रामटेक,	
pushpaa,	पुष्प,	पुष्पा,	
dhoraji,	धोरजी,	धोराजी,	
masaledaar,	मसलेदार,	मसालेदार,	
surveen,	सूर्वीन,	सुरवीन,	
angraji,	अंगराजी,	अंग्रज़ी,	
chero,	चेरो,	चेरो,	
pisaai,	पिसाई,	पिसाई,	
kaningham,	कनिनघम,	कनिंघम,	
refeli,	रिफीली,	रेफेली,	
jubaan,	जुबान,	ज़ुबान,	
pahani,	पहनी,	पहनी,	
tejaji,	तेजाजी,	तेजाजी,	
lahrai,	लहरायी,	लहराई,	
kuposhit,	कुपोषित,	कुपोषित,	
chheenk,	छींक,	छींक,	
kahlaya,	कहलाया,	कहलाया,	
laata,	लाटा,	लाता,	
chabate,	चब्ते,	चबाते,	
shamil,	शाील,	शमिल,	
ashrvatath,	आश्वर्थाथ,	अश्वत्थ,	
sugamata,	सुगममता,	सुगमता,	
skootaron,	स्कूटरों,	स्कूटरों,	
babat,	बबात,	बाबत,	
suriname,	सुरिनामे,	सूरीनाम,	
jangadnaa,	जंगदना,	जनगणना,	
chand,	चांद,	चंद,	
updraviyon,	उप््रवियों,	उपद्रवियों,	
shamitabh,	शमीतमभ,	शमिताभ,	
francisko,	फ्रैंसिस्को,	फ्रांसिस्को,	
bijak,	बीजक,	बीजक,	
dinank,	दिनंक,	दिनांक,	
apnani,	अपनानी,	अपनानी,	
jodta,	जोड़ता,	जोड़ता,	
gaen,	गान,	गाएं,	
kalpi,	कल्प,	कालपी,	
keede,	कीड़,	कीड़े,	
upadrawon,	उपाद्रों,	उपद्रवों,	
augusta,	अगुस्त,	अगस्ता,	
nora,	नोरा,	नोरा,	
chaturdik,	चतुर्दिक,	चतुर्दिक,	
gic,	जीईसी,	जीआईसी,	
aagaa,	आगा,	आग़ा,	
bamba,	बांबा,	बंबा,	
mohim,	मोहिम,	मोहिम,	
profit,	प्रोफिट,	प्रॉफिट,	
tufail,	तुफैइल,	तुफैल,	
usaki,	उसकी,	उसकी,	
kaji,	काजी,	काजी,	
ekaee,	ईकाई,	इकाई,	
joddta,	जोड़ता,	जोड़ता,	
dhatna,	ढतना,	धटना,	
pipraa,	पिपरा,	पिपरा,	
caolan,	कॉलनन,	कोलन,	
east,	ईस्ट,	ईष्ट,	
processing,	प्रोसेसिंग,	प्रॉसेसिंग,	
maangi,	मांगी,	मांगी,	
ekattha,	इकट्ठा,	इकट्ठा,	
aakash,	आकाश,	आकाश,	
aryma,	अर्यमा,	अर्यमा,	
lalak,	लालक,	ललक,	
pam,	पाम,	पैम,	
dipika,	दीपिका,	दीपिका,	
bagd,	बागड़,	बगड़,	
hariyali,	हरियाली,	हरियाली,	
ratrichar,	रत्रिचार,	रात्रिचर,	
masse,	मस्स,	मस्से,	
garjana,	गरजाना,	गर्जना,	
narsanhar,	नरसंहार,	नरसंहार,	
prathmikta,	प्राथमिकता,	प्राथमिकता,	
farms,	फर्म्स,	फार्म्स,	
guthalidar,	गुथाीदार,	गुठलीदार,	
sagrika,	साग्रिका,	सागरिका,	
kamjor,	कमजोर,	कमज़ोर,	
pratiyon,	प्रतियों,	प्रतियों,	
namankano,	नमानकों,	नामांकनों,	
proud,	प्राडड,	प्रौढ,	
chaktte,	चक्ते,	चकत्ते,	
flynn,	फ्लिन,	फ्लिन,	
asamanjasya,	असमंजज्य,	असामंजस्य,	
catholic,	कैथलिक,	कैथोलिक,	
padrauna,	पद्रौण,	पडरौना,	
jivaniyan,	जीवनीययां,	जीवनियां,	
nakam,	नकाम,	नाकाम,	
vershan,	वर्षण,	वर्शन,	
shararat,	शराररत,	शरारत,	
angadh,	अंगढ़,	अनगढ़,	
masaaledaar,	मसालेदार,	मसालेदार,	
hindon,	हिंदों,	हिंडन,	
deepan,	दीपान,	दीपन,	
panchang,	पांचंग,	पंचांग,	
lenewali,	लेनेवाली,	लेनेवाली,	
handiyaa,	हंडिया,	हंडिया,	
vidhaaon,	विधाओं,	विद्याओं,	
latkate,	लटकते,	लटकाते,	
bakuu,	बकुू,	बाकू,	
bachti,	बचती,	बचती,	
soccer,	सॉकर,	सॉकर,	
jodo,	जोड़ो,	जोड़ो,	
baani,	बानी,	बानी,	
vitark,	वितरक,	वितर्क,	
doordarshan,	दूरदर्शन,	दूरदर्शन,	
chadhane,	चढ़ने,	चढ़ने,	
nirdhaarit,	निर्धारित,	निर्धारित,	
nokari,	नोकरी,	नोकरी,	
halt,	हाल्ट,	हाल्ट,	
pakayen,	पकाएं,	पकाएं,	
thakkar,	ठक्कार,	ठक्कर,	
ballistic,	बैलिस्टिक,	बैलिस्टिक,	
farukhabad,	फरुख़ाड़,	फर्रुखाबाद,	
peg,	पेज,	पेग,	
jeen,	जीन,	जिन,	
deewani,	दीवानी,	दिवानी,	
sanjeevan,	संजीवन,	संजीवन,	
gayitri,	गयित्री,	गायत्री,	
dyeyvadi,	द्यायवादी,	ध्येयवादी,	
ainth,	ऐंठ,	ऐंठ,	
theharne,	ठहरने,	ठहरने,	
duvidhaayein,	दुविधाएं,	दुविधाएं,	
vartamaan,	वार्तमान,	वर्तमान,	
khairati,	खैरती,	खैराती,	
csi,	सीसीआई,	सीएसआई,	
satti,	सत्ती,	सत्ती,	
addon,	एड़ों,	अड्डों,	
salve,	सल्वे,	साल्वे,	
lakshmighar,	लक्ष्मीघर,	लक्ष्मीधर,	
bhulon,	भूलों,	भूलों,	
priyamani,	प्रियमनि,	प्रियामणि,	
lootmar,	लूटमार,	लूटमार,	
alnkaaron,	अलंकारों,	अलंकारों,	
navaa,	नवा,	नवा,	
dhasmaanaa,	धस्मना,	धस्माना,	
janaganna,	जनगान्,	जनगणना,	
nichaai,	निचाई,	नीचाई,	
sulaati,	सुलाती,	सुलाती,	
phod,	फोड़,	फोड़,	
nahargadh,	नहररगढढ,	नाहरगढ,	
spear,	स्पीयर,	स्पीयर,	
manch,	मांच,	मंच,	
joint,	जॉइंट,	ज्वाइंट,	
pulmonary,	पुल्मोनरी,	पल्मोनरी,	
packageon,	पैकाजन,	पैकेजों,	
neet,	नीट,	नीट,	
nischal,	निस्चाल,	निश्चल,	
badh,	बा़,	बाध,	
aamod,	आमोद,	आमोद,	
machanon,	मचनों,	मचानों,	
nicky,	निकी,	निकी,	
shamadan,	शमादान,	शमादान,	
langaron,	लंगारों,	लंगरों,	
khaein,	खाएं,	खाएं,	
capacitor,	कैपेसिटर,	कैपेसिटर,	
abbaasi,	अब्बासी,	अब्बासी,	
damle,	डमले,	दामले,	
agvaai,	अग्वाई,	अगवाई,	
fermion,	फर्मियन,	फर्मिऑन,	
susanskrut,	सुसंसकृत,	सुसंस्कृत,	
sankhyayen,	साख्यायं,	संख्याएं,	
mangni,	मांगनी,	मांगनी,	
namo,	नमो,	नामो,	
farhin,	फरहीी,	फरहीन,	
mashrak,	मशर्क,	मशरक,	
bhrant,	भ्रंत,	भ्रांत,	
lalkarta,	लाककर्ता,	ललकारता,	
mem,	मेम,	मेम,	
ikai,	ईकाई,	इकाई,	
jeenon,	जीनों,	जीनों,	
anuthi,	अनुथी,	अनूठी,	
shirshakon,	शिर्ककों,	शीर्षकों,	
dahan,	दहन,	दहन,	
stanadhari,	स्तनाधारी,	स्तनधारी,	
putle,	पुटल,	पुतले,	
vartaman,	वार्तमान,	वर्तमान,	
jvar,	ज्वर,	ज्वार,	
phalitartha,	फलित्रत्थ,	फलितार्थ,	
rak,	रक,	राक,	
alphabet,	अल्पाबेट,	अल्फ़ाबेट,	
lavasa,	लवासा,	लवासा,	
sachidanand,	सचीदंनांड,	सच्चिदानंद,	
morya,	मोर्या,	मौर्या,	
generat,	जनरेट,	जेनरेट,	
khayen,	खाएें,	खाएं,	
dual,	डुएल,	ड्युअल,	
asurkshit,	असुर्षित,	असुरक्षित,	
pizza,	पिज्ज़ा,	पिज्जा,	
sarkaaron,	सरकारों,	सरकारों,	
rana,	राना,	राणा,	
maksad,	मकसस,	मक्सद,	
farth,	फर्थ,	फर्थ,	
icc,	आईसीसी,	आइसीसी,	
policy,	पॉलिसी,	पालिसी,	
alba,	अल्बा,	अल्बा,	
tanbe,	तंबे,	तांबे,	
dukhit,	दुखित,	दुखित,	
rajinama,	रजीनममा,	राजीनामा,	
tapuwo,	तापूवो,	टापुओं,	
khajrana,	खजराना,	खजराना,	
jaun,	जौन,	जौं,	
tuesday,	ट्येदे,	ट्यूजडे,	
kabaddi,	कबाड़ी,	कबड्डी,	
jeevant,	जीवंत,	जीवंत,	
jamaeya,	जमाई,	जमाया,	
jamaya,	जमाया,	जमाया,	
vash,	वाश,	वश,	
bhooswaami,	भूस्वमी,	भूस्वामी,	
hingis,	हिंगिस,	हिंगिस,	
routing,	रोउटिंग,	रूटिंग,	
chaudhawan,	चौधवान,	चौदहवां,	
lehna,	लेना,	लहना,	
anuprayogon,	अनुप्राोगों,	अनुप्रयोगों,	
parnell,	पर्नेल,	पार्नेल,	
seth,	सेठ,	सेथ,	
jamayaa,	जमाया,	जमाया,	
mahanideshak,	महानिदेशक,	महानिदेशक,	
saltnat,	साल्टनत,	सल्तनत,	
chhekein,	छेकें,	छींके,	
chennai,	चेनना,	चेन्नई,	
lakshyon,	लक्ष्यों,	लक्ष्यों,	
prashasnik,	प्रशस्निक,	प्रशासनिक,	
client,	क्लाइंट,	क्लांइट,	
pau,	पाऊ,	पौ,	
zulmon,	जल्मों,	जुल्मों,	
mauley,	मौले,	मौले,	
thief,	थीफ,	थीफ,	
aawazon,	आवाजों,	आवाज़ों,	
should,	शोल्ड,	शुड,	
swarupon,	स्वरूपों,	स्वरुपों,	
sanchar,	सांचार,	संचार,	
varddhaman,	वर्द्धमान,	वर्द्धमान,	
aerobic,	एयोबिक,	एरोबिक,	
dazy,	देजी,	डेजी,	
lagatar,	लगातर,	लागातार,	
racer,	रेसर,	रेसर,	
yarayan,	यारायन,	यात्राएं,	
naksalwad,	नकसलववाद,	नक्सलवाद,	
ginee,	गिनी,	जिनी,	
agende,	एजेंडे,	एजेंडे,	
tantrikaon,	तंत्रिकाओं,	तंत्रिकाओं,	
tantron,	तंत्रों,	तंत्रों,	
greest,	ग्रीस्ट,	ग्रीस्ट,	
grihnagar,	गृहणागर,	गृहनगर,	
machanno,	मचाननों,	मचानों,	
pathykramon,	पाठ्यक्रमों,	पाठ्यक्रमों,	
raajneetikaran,	राजनीतीकाण,	राजनीतीकरण,	
patakshep,	पताक्षेप,	पटाक्षेप,	
hamalavar,	हमलावर,	हमलावर,	
alochakon,	अलोचकों,	आलोचकों,	
pmch,	पीएचएच,	पीएमसीएच,	
ecuador,	ईक्वूडर,	इक्वाडोर,	
putale,	पुटले,	पुतले,	
tikone,	टिकोन,	तिकोने,	
laigikata,	लैगीकता,	लैंगिकता,	
pakaen,	पकाएं,	पकाएं,	
bhoogol,	भूगोल,	भूगोल,	
chikitsakon,	चिकित्सकों,	चिकित्सकों,	
jira,	जीरा,	जीरा,	
ravle,	रावले,	रावले,	
vanshavad,	वंशवव,	वंशवाद,	
untees,	उनटीस,	उनतीस,	
jaayke,	जायके,	जायके,	
supachy,	सुपच्य,	सुपाच्य,	
mehmaan,	मेहमान,	मेहमान,	
ranapur,	रानापुर,	रानापुर,	
bantne,	बांटने,	बंटने,	
janahani,	जननाही,	जनहानि,	
vaitravati,	वैत्रवती,	वैत्रवती,	
aapdaein,	आपदाईं,	आपदाएं,	
amanat,	अमानत,	अमानत,	
tahkhaana,	तहखाना,	तहखाना,	
badhaati,	बढ़ाती,	बढ़ाती,	
chidhate,	चिढ़ते,	चिढ़ते,	
upabhokta,	उपभोकता,	उपभोक्ता,	
changul,	चंगुल,	चंगुल,	
aagat,	आगत,	आगत,	
badhit,	बढित,	बाधित,	
algavwaadi,	अलगववादी,	अलगाववादी,	
ambaani,	अमबानी,	अंबानी,	
jatak,	जटक,	जातक,	
afroz,	अफरोज़,	अफरोज,	
mul,	मूल,	मूल,	
kav,	काव,	काव,	
colorado,	कलरोडोो,	कोलोराडो,	
karur,	करुर,	करूर,	
maap,	माप,	माप,	
divyata,	दिव्यता,	दिव्यता,	
bandhate,	बांधते,	बांधते,	
raghavan,	राघवां,	राघवन,	
advivas,	अद्विवास,	अधिवास,	
padegaa,	पडेगा,	पड़ेगा,	
fogat,	फोगत,	फोगाट,	
ashanka,	अशंका,	आशंका,	
atmaen,	आत्में,	आत्माएं,	
tahakhana,	तहखाना,	तहखाना,	
aagashe,	आगशे,	आगाशे,	
falibhoot,	फलीभूत,	फलीभूत,	
pagbadha,	पगगबढ़ा,	पगबाधा,	
tambe,	तंबे,	तांबे,	
shrimati,	श्रीमती,	श्रीमति,	
amaanati,	अमानती,	अमानती,	
stra,	स्ट्रा,	स्ट्रे,	
standhaari,	स्तनधारी,	स्तनधारी,	
kanika,	कनिका,	कणिका,	
atke,	अटीक,	अटके,	
vimarsh,	विमर्ष,	विमर्श,	
vije,	विजे,	वाइज,	
entone,	इंटन,	एंटोन,	
helper,	हेलपर,	हेल्पर,	
nuskhe,	नुस्खे,	नुस्खे,	
ulahna,	उलहना,	उलाहना,	
nigar,	निगार,	निगर,	
patwari,	पतवारी,	पटवारी,	
self,	सेल्फ,	सेल्फ,	
dipan,	दीपान,	दीपन,	
modules,	मॉडुललस,	मॉड्यूल्स,	
bharte,	भर्ते,	भरते,	
langdon,	लंगगडन,	लैंगडन,	
ladate,	लाड़ते,	लड़ते,	
alaps,	अलप्स,	ऐल्प्स,	
jamaati,	जमाती,	जमाती,	
trabal,	ट्रेबल,	ट्रेबल,	
janch,	जांच,	जाँच,	
bahrupiya,	बहरुपीय,	बहरूपिया,	
shaakhaaen,	शाखाएं,	शाखाएं,	
saathsaath,	साठसाथ,	साथसाथ,	
maalish,	मालिश,	मालिश,	
main,	माइन,	मैन,	
baraat,	बरात,	बरात,	
samoaa,	समो,	सामोआ,	
aanad,	आनाद,	आनद,	
allah,	अल्लाह,	आल्हा,	
kamere,	कममेर,	कमेरे,	
fikra,	फिक्र,	फिक्र,	
baljeet,	बालजीत,	बलजीत,	
dinosaur,	दिनोसौर,	डायनासोर,	
jhuthala,	झुठला,	झुठला,	
fuji,	फुजी,	फ्यूजी,	
manner,	मैननर,	मैनर,	
balli,	बल्ली,	बल्ली,	
dhamkaataa,	धमकाता,	धमकाता,	
barahsinga,	बारहससंहा,	बारहसिंगा,	
kartik,	कार्तिक,	कार्तिक,	
hostes,	होस्टेस,	होस्टेस,	
scooteron,	स्कूटरों,	स्कूटरों,	
sahooliyata,	सहूलियता,	सहूलियत,	
mubarakpur,	मुबारपुरर,	मुबारकपुर,	
somi,	सोमी,	सोमी,	
menon,	मेनों,	मैनन,	
raaj,	राज़,	राज,	
falibhut,	फलीभूत,	फलीभूत,	
eliminator,	एलिमिनेटर,	एलिमिनेटर,	
dhandhanya,	धांढन्य,	धनधान्य,	
bravo,	ब्रेवो,	ब्रावो,	
antmurkh,	अंतमुर्ख,	अंतर्मुख,	
saanketika,	सांकेतिका,	सांकेतिक,	
sambhrant,	संभरंत,	संभ्रांत,	
matix,	मेट्किस,	मैट्रिक्स,	
hawalaat,	हवालत,	हवालात,	
boliye,	बोलिय,	बोलिए,	
udaanen,	उड़नें,	उड़ानें,	
pulse,	पल्स,	पल्स,	
uttra,	उत्तर,	उत्तरा,	
byrun,	बीरन,	बायर्न,	
jeremy,	जेरेमी,	जेरेमी,	
chhootane,	छुटने,	छूटने,	
yugam,	युगम,	युग्म,	
dak,	डक,	डाक,	
sanchari,	संचाीरी,	संचारी,	
samoa,	समू,	सामोआ,	
skhalan,	स्खलन,	स्खलन,	
gaya,	गाया,	गया,	
bhuli,	भुली,	भूली,	
kursiyon,	कुर्सियों,	कुर्सियों,	
goyal,	गोयल,	गोयल,	
chhupkr,	छुप्कर,	छुपकर,	
robinson,	रोबिंसन,	रॉबिंसन,	
cavity,	कैविटी,	कैविटी,	
sayan,	सायन,	सायं,	
girti,	गिरती,	गिरती,	
bagiyon,	बागियों,	बागियों,	
choron,	चोरों,	चोरों,	
jaagriti,	जाग्रीती,	जागृति,	
prekshakon,	प्रेक्षकों,	प्रेक्षकों,	
bayern,	बायरन,	बायर्न,	
shantikal,	शांतिकाल,	शांतिकाल,	
arjent,	अर्जेंट,	अर्जेंट,	
lapetane,	लेपटने,	लपेटने,	
jwaron,	ज्वरों,	ज्वारों,	
zuban,	जुबान,	ज़ुबान,	
brighton,	ब्राइटन,	ब्रिगटन,	
jeevan,	जीवन,	जीवन,	
barsaataa,	बरसाता,	बरसाता,	
sarganaon,	सर्गनाओं,	सरगनाओं,	
adhyaynrat,	अध्ययन्तत,	अध्ययनरत,	
lengdan,	लेंग्नन,	लैंगडन,	
liger,	लाइगर,	लिगर,	
trap,	ट्रेप,	ट्रैप,	
emil,	एमिल,	एमिल,	
thenga,	ठेंगा,	ठेंगा,	
rukavaton,	रुकावटों,	रूकावटों,	
darawani,	दरवानी,	डरावनी,	
vidyaaon,	विद्याओं,	विद्याओं,	
jinon,	जिनों,	जीनों,	
welding,	वेल्डिंग,	वेल्डिंग,	
down,	डाउन,	डाउन,	
devisinh,	डिविसिंह,	देवीसिंह,	
kailana,	कैललना,	कायलाना,	
stain,	स्टेन,	स्टैन,	
bharakaaya,	भड़काया,	भड़काया,	
dhrupad,	धृरपपद,	ध्रुपद,	
maajin,	माजिन,	माजिन,	
kamraj,	कमराजज,	कामराज,	
theaters,	थीटर्स,	थिएटर्स,	
korola,	कोरोला,	कोरोला,	
dubhashiyon,	दुभाषियों,	दुभाषियों,	
hairam,	हैराम,	हैरम,	
vegyanik,	वेज्ञानिक,	वैज्ञानिक,	
cute,	कूट,	क्यूट,	
chakatte,	चकतते,	चकत्ते,	
purjon,	पुरजों,	पुर्जों,	
anukulta,	अनुकुलता,	अनुकूलता,	
apavartit,	अपवर्तित,	अपवर्तित,	
barpaayaa,	बरपाया,	बरपाया,	
chhure,	छुरे,	छुरे,	
ragon,	रगगों,	रागों,	
rajma,	राजमा,	राजमां,	
iaan,	ईयन,	इआन,	
bavra,	बावरा,	बावरा,	
baadhaon,	बाधाओं,	बाधाओं,	
urvarakon,	उर्वारों,	उर्वरकों,	
mool,	मूल,	मूल,	
vicharakon,	विचारकों,	विचारकों,	
kalika,	कालिका,	कालिका,	
kalpanaon,	कल्पनाओं,	कल्पनाओं,	
sametti,	समेत्,	समेटती,	
uchhalane,	उछालने,	उछालने,	
daravani,	दरवानी,	डरावनी,	
jheelon,	झीलों,	झीलों,	
kshitij,	क्षितिज,	क्षितिज,	
corolla,	कोरोला,	कोरोला,	
mauritius,	मॉरीशस,	मॉरिशस,	
shaili,	शैली,	शैली,	
acapulco,	एकापलल्को,	अकापुल्को,	
mysore,	मैसूर,	मैसोर,	
taaja,	ताजा,	ताजा,	
shud,	शुद,	शुड,	
frost,	फ्रॉस्ट,	फ्रॉस्ट,	
nirbadh,	निर्बाध,	निर्बाध,	
artery,	आर्टरी,	आर्टरी,	
dabhoi,	दभोई,	डभोई,	
adhik,	अधिक,	अधीक,	
convocation,	कन्वोशनशन,	कन्वोकेशन,	
dit,	डीट,	डिट,	
reduction,	रेडक्शन,	रिडक्शन,	
anishwarwadi,	अनिश्ववरदादी,	अनीश्वरवादी,	
kankar,	कांकर,	कंकर,	
dolane,	डोलने,	डोलने,	
suniti,	सुनीती,	सुनीति,	
benis,	बेनिस,	बेनिस,	
muhavare,	मुहावरे,	मुहावरे,	
laati,	लाटी,	लाती,	
ukranian,	उक्राणियां,	यूक्रेनियन,	
mezbaani,	मेजबानी,	मेज़बानी,	
kamzor,	कमजजोर,	कमज़ोर,	
devidson,	डेविड्सन,	डेविडसन,	
born,	बॉर्न,	बोर्न,	
polimer,	पॉलीमर,	पॉलिमर,	
nirbaadh,	निर्बाध,	निर्बाध,	
jud,	जुड़,	जूड,	
tyred,	टायरड,	टायर्ड,	
tranjister,	ट्रांजीस्टर,	ट्रांजिस्टर,	
sanchayan,	संचायन,	संचयन,	
baabat,	बाबत,	बाबत,	
ashariri,	आशारीरी,	अशरीरी,	
abbasi,	अब्बसी,	अब्बासी,	
jarda,	जार्ा,	जर्दा,	
firmian,	फर्ममिया,	फर्मिऑन,	
men,	मेन,	मैन,	
aashriton,	आश्रितों,	आश्रितों,	
dhasmana,	धस्मना,	धस्माना,	
sabhyata,	सभ्यता,	सभ्यता,	
chipakne,	चिपकने,	चिपकने,	
kathfodve,	कथ्होदवे,	कठफोड़वे,	
chaudah,	चौदहाह,	चौड़ा,	
dhaaga,	ढागा,	धागा,	
sacchidanand,	सच्चींदन,	सच्चिदानंद,	
navdha,	नववा,	नवधा,	
kap,	काप,	कप,	
complex,	कॉप््््क,	कॉम्प्लेक्स,	
ghontane,	घोंटने,	घोंटने,	
saraha,	सराा,	सराहा,	
ikattha,	इकट्ठा,	इकट्ठा,	
avishvaasniy,	अविश्वस्ीी,	अविश्वसनीय,	
maryaadaaon,	मररयादाओं,	मर्यादाओं,	
sunega,	सुनेगा,	सुनेगा,	
uplakshya,	उपलाक्ष्य,	उपलक्ष्य,	
airway,	एयर्वे,	एयरवे,	
premlata,	प्रेमलता,	प्रेमलता,	
avisvasniya,	अविवस्वीीय,	अविश्वसनीय,	
kusumalta,	कुसुमालता,	कुसुमलता,	
daglas,	डगलास,	डगलस,	
pataakshep,	पताक्षेप,	पटाक्षेप,	
prahaarak,	प्रहारक,	प्रहारक,	
sabhaein,	सभाएं,	सभाएं,	
wattson,	वा्ससन,	वाटसन,	
barasingha,	बारससंहा,	बारहसिंगा,	
furti,	फुर्ती,	फूर्ति,	
sunasir,	सुनासिर,	सुनासीर,	
mhamantra,	महामंत्र,	महामंत्र,	
maddy,	मैडी,	मैडी,	
tughlaq,	तुगलाक,	तुगलक,	
jalgati,	जलगती,	जलगति,	
singer,	सिंगर,	सिंगार,	
aryika,	अर्यिका,	आर्यिका,	
bangbandhu,	बांगबंधु,	बंगबंधु,	
avaigyanik,	अवैज्ञानिक,	अवैज्ञानिक,	
aj,	अज,	एजे,	
chithhi,	चिती,	चिठ्ठी,	
pummi,	पूम्मी,	पम्मी,	
simmy,	सिम्मी,	सिमी,	
yojanaein,	योजनाएं,	योजनाएं,	
aloso,	एलोसो,	अलोंसो,	
bowling,	बोलिंग,	बाउलिंग,	
bewakoofaanaa,	बेवबूजना,	बेवकूफाना,	
alha,	अल्हा,	आल्हा,	
khinchkar,	खींचकर,	खिंचकर,	
bisavan,	बीसवान,	बीसवां,	
bokaro,	बोकरो,	बोकारो,	
shakhayan,	शाखायान,	शाखाएं,	
longoval,	लोंगववल,	लोंगोवाल,	
zamana,	ज़माना,	ज़माना,	
amanathi,	अमननथी,	अमानती,	
emrald,	एमराल्ड,	एमरल्ड,	
siswa,	सिस्वा,	सिसवा,	
amargarh,	अमरगाढ़,	अमरगढ़,	
mud,	मुड़,	मूड,	
jio,	जियो,	जीयो,	
fawaare,	फवारे,	फव्वारे,	
shelling,	शेलिंग,	शेलिंग,	
ipc,	आईपीसी,	आईपीसी,	
sabah,	सबाह,	साबाह,	
lahanaa,	लहना,	लहना,	
padha,	पढ़ा,	पढ़ा,	
karyakartaon,	कार्यककत्राओं,	कार्यकर्ताओं,	
daaw,	दाव,	दाव,	
edan,	ईडन,	एडेन,	
badhaon,	बाधाओं,	बाधाओं,	
khene,	खेने,	खेने,	
chhetri,	छेत्री,	छेत्री,	
lochdar,	लॉकडहार,	लोचदार,	
aayojak,	आयोजक,	आयोजक,	
mtech,	मैटच,	एमटेक,	
pailoton,	पैलोटों,	पायलटों,	
marvad,	मार्वाद,	मारवाड़,	
manjil,	मंजिल,	मंजिल,	
venkataraman,	वेंकटरमण,	वेंकटरमन,	
jini,	जिनी,	जिनी,	
tiwari,	तिवाड़ी,	तिवारी,	
nevedya,	नेवेदि,	नैवेद्य,	
prahlad,	प्रह्लाद,	प्रहलाद,	
jogging,	जॉगिंग,	जॉगिंग,	
sarkaa,	सरका,	सरका,	
bona,	बोना,	बोना,	
championship,	चैंपिंपिश,	चैंपियनशिप,	
bhagaane,	भगाने,	भगाने,	
machaaye,	मचाये,	मचाए,	
dang,	डांग,	दंग,	
arth,	आर्थ,	अर्थ,	
quantico,	क्वांटिको,	क्वांटिको,	
ghanakar,	घनाकर,	घनाकार,	
abbott,	अबबोट,	एबट,	
bakhshne,	बख्शने,	बख्शने,	
ot,	ओटी,	ओत,	
blossom,	ब्लोस्म,	ब्लॉसम,	
pitaamaha,	पीतामाहा,	पितामह,	
jatara,	जतारा,	जतरा,	
neto,	नेटो,	नेटो,	
tribunal,	ट्रिबुनल,	ट्रिब्यूनल,	
ikaiyon,	ईकाईयों,	इकाईयों,	
swaarthparak,	स्वार्थपारक,	स्वार्थपरक,	
jerusalem,	जेरूसलम,	यरूशलेम,	
amavsya,	अमावस्य,	अमावस्या,	
kaagaz,	काग़ज़,	कागज़,	
udghosh,	उद्घोष,	उदघोष,	
map,	मैप,	माप,	
pahantaa,	पहनता,	पहनता,	
sarka,	सरका,	सरका,	
bhootal,	भूतल,	भूतल,	
shrinkhalaon,	शृंखलाओं,	श्रंखलाओं,	
shrotaon,	श्रोतताओं,	श्रोताओं,	
dikhaai,	दिखाई,	दिखार्इ,	
chadar,	चादार,	चादर,	
nabja,	नज्जा,	नब्ज़,	
avishvasniya,	अविश्वसीनीय,	अविश्वसनीय,	
saunpane,	सौनपने,	सौंपने,	
paramparikata,	पारंपरिकता,	पारंपरिकता,	
dhuriya,	धुरिया,	धुरिया,	
singapore,	सिंगापोर,	सिंगापुर,	
sathiya,	सथिया,	साथिया,	
jassi,	जस्सी,	जस्सी,	
sandrbh,	संद्रभ,	संदर्भ,	
boliy,	बोलिय,	बोलिए,	
liberation,	लिब्रेशन,	लिब्रेशन,	
mates,	मैट्स,	मेट्स,	
mithya,	मिथ्या,	मिथ्या,	
taapmaanon,	तापमानों,	तापमानों,	
auchity,	ऑचिती,	औचित्य,	
bhira,	भिरा,	भीरा,	
daakhile,	दाखिले,	दाखिले,	
rosario,	रोसरियो,	रोसारियो,	
kaushalata,	कौशलता,	कौशलता,	
kochi,	कोची,	कोच्चि,	
girijagharon,	गिरिजाघरों,	गिरजाघरों,	
utaney,	उतने,	उतने,	
niveshkartaa,	निवेशकर्ता,	निवेशकर्ता,	
paraffin,	पराफीन,	पैराफिन,	
soya,	सोया,	सोया,	
ganthon,	गंंथों,	गांठों,	
sube,	सूबे,	सूबे,	
paathyakramon,	पाठययक्रमों,	पाठ्यक्रमों,	
utne,	उतने,	उतने,	
karvi,	कारवी,	कर्वी,	
gujare,	गुजरे,	गुजारे,	
deji,	देजी,	डेजी,	
submit,	सब्मित,	सबमिट,	
varenya,	वार्णेय,	वरेण्य,	
hindan,	हिंदन,	हिंडन,	
adharit,	आधारित,	आधारित,	
vimarsho,	विमर्शों,	विमर्शों,	
sanjivan,	संजीवन,	संजीवन,	
shervasiyon,	श्रवासियों,	शहरवासियों,	
upbhokta,	उपभोकता,	उपभोक्ता,	
karanjiya,	करंजीय,	करंजिया,	
dealership,	डेलर्शिप,	डीलरशिप,	
naukari,	नौकरी,	नोकरी,	
bilhaur,	बिल्हौर,	बिल्हौर,	
surana,	सुरना,	सुराणा,	
suiyan,	सुयान,	सूइयां,	
firti,	फिरती,	फिरती,	
vishwasniiyataa,	विश्वन्ीतीता,	विश्वसनीयता,	
wicket,	विकेट,	विकेट,	
maanga,	मांगा,	मांगा,	
eksath,	एकसाठ,	एकसाथ,	
niptaara,	निपटारा,	निपटारा,	
mahapran,	महाप्राण,	महाप्राण,	
kaivelari,	क्येवलरी,	कैवेलरी,	
siera,	सियरा,	सिएरा,	
saraahi,	सााही,	सराही,	
khanda,	खंडा,	खंडा,	
divya,	दिव्य,	दिव्य,	
siyah,	सियाह,	सियाह,	
tik,	टीक,	टिक,	
samnvyak,	समन्वयकक,	समन्वयक,	
jivaniya,	जीवनीय,	जीवनियां,	
shubhankar,	शुभंकार,	शुभंकर,	
tugalki,	तुगलकी,	तुगलकी,	
halchal,	हलचल,	हालचाल,	
jorhta,	जोड़ता,	जोड़ता,	
mainan,	माइन,	मैनन,	
gyapit,	ज्ञापित,	ज्ञापित,	
chadhne,	चढ़ने,	चढ़ने,	
sandrbhon,	संद्भभों,	संदर्भों,	
arica,	अरिका,	एरिका,	
yatn,	यतन,	यत्न,	
bhaya,	भाया,	भय,	
naamo,	नामो,	नामो,	
jardaa,	जर्दा,	जर्दा,	
katlari,	काललारी,	कटलरी,	
bagichi,	बगीीी,	बगीची,	
aparivartanshil,	अपरिवर्तनिश,	अपरिवर्तनशील,	
tirupati,	तिरुपति,	तिरूपति,	
mangani,	मंगानी,	मांगनी,	
ajhar,	आजार,	अजहर,	
choro,	चोरो,	चोरों,	
sochane,	सोचने,	सोचने,	
bharatanatyam,	भारतनात्मम,	भरतनाट्यम्,	
gtor,	ग्टोर,	जीतोड़,	
hakikat,	हकिितत,	हकीकत,	
mood,	मूद,	मूड,	
jatati,	जतती,	जताती,	
patkathaayein,	पट्थाथाएं,	पटकथाएं,	
sarsa,	सर्स,	सरसा,	
achanbha,	अचंंा,	अचंभा,	
pehnate,	पहनाते,	पहनते,	
nirdharit,	निर्धारित,	निर्धारित,	
jaybaan,	जयबान,	जयबाण,	
anka,	अंका,	अंक,	
ghise,	घिसे,	घिसे,	
rhamat,	रहमतत,	रहमत,	
ebt,	ईबीटी,	एबट,	
amanth,	अमांत,	अमानत,	
bisva,	बिस्वा,	बिस्वा,	
ekaeyon,	ईकाईयों,	इकाईयों,	
avaigyanic,	अवैज्ञानिक,	अवैज्ञानिक,	
jad,	जाद,	जड़,	
dikhai,	दिखाई,	दिखाई,	
chandon,	चंदों,	चंदों,	
then,	थें,	थेन,	
bhutto,	भुट्तों,	भुट्टो,	
el,	एल,	ऐल,	
himali,	हिमली,	हिमाली,	
root,	रुट,	रूट,	
alai,	अलाई,	अली,	
sooraj,	सूरज,	सूरज,	
slide,	स्लाइड,	स्लाइड,	
prashasanon,	प्रशासनों,	प्रशासनों,	
bahamas,	बहहस,	बहामास,	
dastavej,	दस्तावेज़,	दस्तावेज,	
boston,	बोस्टन,	बॉस्टन,	
hamala,	हमला,	हमला,	
kakkar,	काकर,	कक्कड़,	
nanavati,	नानावटी,	नानावती,	
jat,	जाट,	जात,	
saja,	सजा,	साजा,	
mitao,	मिटाओ,	मिटाओ,	
dikhaain,	दिखाइं,	दिखाईं,	
uthaakar,	उठाकर,	उठाकर,	
najibabad,	नाजीबबाद,	नजीबाबाद,	
katlary,	का्लररी,	कटलरी,	
vanshdhar,	वंशधर,	वंशधर,	
panaamaa,	पनामा,	पनामा,	
visheshadhikar,	विशेषाधिकार,	विशेषाधिकार,	
kamaauu,	कमाऊ,	कमाऊ,	
kundaliya,	कुंडलिया,	कुंडलियाँ,	
simtata,	सिमतता,	सिमटता,	
isaaiyon,	ईसाईयों,	ईसाइयों,	
avru,	अवरू,	अवरु,	
akhil,	अखिल,	अखिल,	
tughlaqabad,	तुल्लाबाबाद,	तुगलकाबाद,	
sakshan,	सक्षण,	सक्शन,	
hasino,	हासिनो,	हसीनों,	
mtake,	मटके,	एमटेक,	
avegyanik,	अवैज्ञानिक,	अवैज्ञानिक,	
kumavat,	कुमावत,	कुमावत,	
mol,	मोल,	मोल,	
chhai,	छाई,	छाई,	
satvat,	सत्वत,	सत्वत,	
brahmlin,	ब्राह्लीम,	ब्रह्मलीन,	
purvaabhaas,	पूर्वाभास,	पूर्वाभास,	
prativadi,	प्रतिवादी,	प्रतिवादी,	
prahsan,	प्राहसन,	प्रहसन,	
chatushkoniy,	चतुत्षणीीय,	चतुष्कोणीय,	
farsi,	फर्सी,	फारसी,	
fode,	फोड़े,	फोड़े,	
oxy,	ऑक्सी,	ऑक्सी,	
chipakane,	चिपकने,	चिपकने,	
bahamaas,	बहहमस,	बहामास,	
saptakranti,	सप्तक्रतिं,	सप्तक्रांति,	
samvedikaran,	संवेदीकरण,	संवेदीकरण,	
awashist,	अवशिष्ट,	अवशिष्ट,	
bhaate,	भाते,	भाते,	
jnhaani,	जनहानी,	जनहानि,	
janganana,	जंगाना,	जनगणना,	
pummy,	पम्मी,	पम्मी,	
gandha,	गंंधा,	गंध,	
qawwali,	क़व्वाली,	कव्वाली,	
harshit,	हर्षित,	हर्षित,	
pahanate,	पहननते,	पहनते,	
emi,	एमी,	एमी,	
tivoli,	तिवोली,	टिवोली,	
pailot,	पैलोट,	पायलट,	
bikherati,	बिखेरती,	बिखेरती,	
maidi,	मैदि,	मैडी,	
jhuthlane,	झुठलाने,	झुठलाने,	
sheli,	शेली,	शैली,	
subhaay,	सुभाय,	सुभाय,	
fefda,	फेफडा,	फेफड़ा,	
janajagran,	जनजाग्ण,	जनजागरण,	
chhudane,	छुड़ाने,	छुडाने,	
asfalt,	असफॉल्ट,	एस्फाल्ट,	
sankhyaein,	संख्याएं,	संख्याएं,	
dwivedi,	द्विवेदी,	द्विवेदी,	
bairakpur,	बैराकपुर,	बैरकपुर,	
birganj,	बीरगंज,	बीरगंज,	
judai,	जुदाई,	जुदाई,	
prapaton,	प्रापतों,	प्रपातों,	
equities,	एक्वीशीज,	इक्विटीज,	
saajan,	साजन,	साजन,	
maori,	मोरी,	माओरी,	
siddhivat,	सिद्धिवत,	सिद्धवट,	
corridor,	कॉरिडोर,	कोरिडोर,	
dose,	डोस,	डोज,	
avuti,	अवुति,	आवृत्ति,	
moolon,	मूलों,	मूलों,	
hathiya,	हथिया,	हथिया,	
udane,	उड़ने,	उड़ाने,	
theinga,	ठेंगा,	ठेंगा,	
pahan,	पहन,	पहन,	
najim,	नाजिम,	नजीम,	
udar,	उदार,	उदर,	
batlakar,	बतलाकार,	बतलाकर,	
kambalon,	कांबलों,	कंबलों,	
pendulam,	पेंदुलम,	पेंडुलम,	
dhiryawaan,	धिर्यवान,	धैर्यवान,	
naksaliyon,	नकसललियों,	नक्सलियों,	
pichde,	पिछड़े,	पिछड़े,	
hahakar,	हहकरर,	हाहाकार,	
saira,	सैरा,	सायरा,	
bakaul,	बकौल,	बकौल,	
aamdi,	आमदी,	आमदी,	
maulviyon,	मौलवियों,	मौलवियों,	
gajara,	गजजरा,	गजरा,	
prapat,	प्रापत,	प्रपात,	
akram,	अक्रम,	अकरम,	
janhani,	जान्हान,	जनहानि,	
avashist,	अवशिष्ट,	अवशिष्ट,	
buzy,	बुजी,	बिजी,	
aagah,	आगाह,	आग़ा,	
formulae,	फॉर्मूलाई,	फार्मूले,	
fodaa,	फोडा,	फोड़ा,	
branti,	ब्रांटि,	भ्रांति,	
varsaache,	वर्सच्चे,	वर्साचे,	
sapat,	सपपत,	सपाट,	
jamui,	जामु,	जमुई,	
harem,	हरेम,	हैरम,	
danga,	डांगा,	दंगा,	
wahikayan,	वाहिकायन,	वाहिकाएं,	
pranit,	प्रणीत,	प्रनीत,	
farheen,	फरहीन,	फरहीन,	
charcha,	चर्चा,	चर्चा,	
junooni,	जुनूनी,	जुनूनी,	
mtec,	एमटीसी,	एमटेक,	
dabi,	दबी,	डाबी,	
sulati,	सुलती,	सुलाती,	
modyuls,	मॉडॉिल्स,	मॉड्यूल्स,	
shavakon,	श्वकों,	शावकों,	
nirdeshikaa,	निर्देशिका,	निर्देशिका,	
nava,	नवा,	नवा,	
bhooli,	भूली,	भूली,	
launcher,	लान्चर,	लांचर,	
jheel,	झील,	झील,	
aasaan,	आसान,	आसान,	
danshil,	दंशील,	दानशील,	
amzera,	अमजेरा,	अमझेरा,	
bandhti,	बांधी,	बंधती,	
saptpadi,	सप्तपादी,	सप्तपदी,	
amarohi,	अमरोही,	अमरोही,	
prathmik,	प्राठ्मिक,	प्राथमिक,	
fusion,	फुजन,	फ्यूजन,	
chaupal,	चौपल,	चौपाल,	
pahnata,	पहनाता,	पहनता,	
rig,	रिग,	रिग,	
ahsaas,	अहसास,	एहसास,	
error,	एरोर,	एरर,	
rangte,	रंगते,	रंगते,	
gyatvy,	ज्ञातवी,	ज्ञातव्य,	
lindan,	लिंदन,	लिंडन,	
haaranaa,	हारना,	हारना,	
aesthetics,	एस्टेटिक्स,	एस्थेटिक,	
evening,	ईविनगंग,	ईवनिंग,	
saimans,	सैमांस,	साइमंस,	
basin,	बसिन,	बेसिन,	
naivegh,	नैवेध,	नैवेद्य,	
putaliyaan,	पुटलियां,	पुतलियां,	
valkkan,	वाक्कन,	वल्कन,	
squash,	स्क्वाश,	स्क्वैश,	
vlc,	वीएलसी,	वीएलसी,	
multae,	मुलताई,	मुल्ताई,	
takra,	टकरा,	टकरा,	
feka,	फेका,	फेका,	
doge,	डोगे,	दोगे,	
nihlani,	निह्लनन,	निहलानी,	
ishaak,	इशाक,	इशाक,	
legaa,	लेगा,	लेगा,	
vaahikayen,	वाहिकाएं,	वाहिकाएं,	
bekabu,	बेकाबू,	बेकाबू,	
mate,	माट,	मेट,	
ayodhyanaath,	अयोध्यनाथ,	अयोध्यानाथ,	
saraaha,	सराहा,	सराहा,	
mayorkaa,	मयोरका,	मयोर्का,	
eddy,	एडी,	एड्डी,	
toka,	टोका,	टोका,	
theni,	थेनी,	थेनी,	
beni,	बेनी,	बैनी,	
tivolee,	टिवोली,	टिवोली,	
prapti,	प्राप्ति,	प्राप्ती,	
kurmi,	कुर्मी,	कुर्मी,	
mejban,	मेबन,	मेज़बान,	
ulte,	उल्टे,	उलटे,	
tippnikar,	तिप्पनीकार,	टिप्पणीकार,	
hamal,	हमल,	हमाल,	
kaagaj,	कागज,	कागज़,	
jodiyon,	जोड़ियों,	जोड़ियों,	
swiftlet,	स्विफ्टेट,	स्विफ्टलेट,	
namavaliyon,	नममविलियों,	नामावलियों,	
baniya,	बनिया,	बनिया,	
isht,	ईष्ट,	ईष्ट,	
ganapati,	गणपती,	गणपति,	
naraingarh,	नारैंगढ़,	नारायणगढ़,	
shrikar,	श्रीकर,	श्रीकर,	
johnson,	जॉन्सन,	जॉनसन,	
langron,	लंग्रों,	लंगरों,	
sanchalanon,	संचलनों,	संचालनों,	
vibhrm,	विभर्म,	विभ्रम,	
jamuei,	जमुए,	जमुई,	
jasper,	जसपरर,	जैस्पर,	
pahnaati,	पहनाती,	पहनाती,	
alnkaar,	अलंकार,	अलंकार,	
raith,	रैठ,	रैथ,	
tapti,	तप्त,	ताप्ती,	
egmore,	एजमोर,	एगमोर,	
adani,	अदनी,	अदाणी,	
chhetter,	छेत्तर,	छेत्र,	
arymaa,	अर्यमा,	अर्यमा,	
bangash,	बंगाश,	बंगश,	
tantrikao,	तंत्रिकाओं,	तंत्रिकाओं,	
sierra,	सियरा,	सिएरा,	
pilepan,	पिलेपन,	पीलेपन,	
avirl,	अविर्ल,	अविरल,	
taseer,	तसीीर,	तासीर,	
tantr,	तंत्र,	तंत्र,	
tapkati,	तपकतती,	टपकती,	
bhusvami,	भूस्वामी,	भूस्वामी,	
stray,	स्त्रैय,	स्ट्रे,	
avranta,	अवरंतता,	अवर्णता,	
bagli,	बगली,	बागली,	
riggs,	रिग्स,	रिग्स,	
osaka,	ओसका,	ओसाका,	
umesh,	उमेश,	उमेश,	
chaukiyan,	चौकियां,	चौकियां,	
bhookhi,	भूखी,	भूखी,	
risaney,	रिसने,	रिसने,	
dharmraj,	धर्मराज,	धर्मराज,	
mejbani,	मेबबनी,	मेज़बानी,	
parosane,	परोसने,	परोसने,	
tasting,	टस्टिंग,	टेस्टिंग,	
vadali,	वदली,	वडाली,	
bantane,	बांटने,	बंटने,	
networking,	नेटवर्किंग,	नेटवर्किग,	
aapka,	आपका,	आपका,	
khatakati,	खटकती,	खटकती,	
kanji,	काजी,	कांजी,	
kalamjeet,	कलमजीत,	कमलजीत,	
vansh,	वंश,	वंश,	
shirshkon,	शिरककों,	शीर्षकों,	
sivan,	सिवन,	सिवान,	
foda,	फोडा,	फोड़ा,	
rooting,	रुटिंग,	रूटिंग,	
bahuchara,	बहुचारा,	बहुचरा,	
bakoul,	बकौल,	बकौल,	
baila,	बैला,	बैला,	
darp,	डर्प,	दर्प,	
parloron,	पार्लोों,	पार्लरों,	
hisham,	हिशम,	हिशाम,	
mooth,	मूथ,	मूठ,	
gochar,	गोचार,	गोचर,	
misha,	मिशा,	मिशा,	
santati,	संतटती,	संतति,	
venezuela,	वेनजज़वलल,	वेनेजुएला,	
anakon,	अनाकों,	अंकों,	
nahargarh,	नहारगगढ़,	नाहरगढ,	
durdarshan,	दूरदर्शन,	दूरदर्शन,	
aset,	असेट,	असेट,	
belcha,	बेलचा,	बेलचा,	
cricketing,	क्रिककिंग,	क्रिकेटिंग,	
tuth,	तूथ,	ट्रुथ,	
visheshanon,	विशेषणों,	विशेषणों,	
lace,	लेस,	लैस,	
farse,	फर्स,	फरसे,	
fisla,	फिसला,	फिसला,	
bheera,	भीरा,	भीरा,	
tareeko,	तरीीको,	तरीको,	
thanvi,	ठनवी,	थानवी,	
tyohaar,	त्योहार,	त्यौहार,	
posta,	पोस्टा,	पोस्ता,	
ranjkta,	रंजकता,	रंजकता,	
fyuji,	फ्यूजी,	फ्यूजी,	
adaani,	अदानी,	अदाणी,	
audhyogikaran,	औद्योगिकरण,	औद्योगिकरण,	
prativaad,	प्रतिवाद,	प्रतिवाद,	
transistor,	ट्रांसिस्टर,	ट्रांजिस्टर,	
jue,	जुए,	जुए,	
malaar,	मलार,	मलार,	
letkar,	लेटकर,	लेटकर,	
chipkane,	चिपकाने,	चिपकने,	
kachche,	कच्चे,	कच्चे,	
bhulaa,	भुला,	भूला,	
prahlad,	प्रह्लाद,	प्रह्लाद,	
dhaarak,	धारक,	धारक,	
aurangabad,	औरंगाबाड़,	औरंगाबाद,	
email,	इमैल,	ईमेल,	
langar,	लंगार,	लंगर,	
nikalogi,	निकालोगी,	निकलेगी,	
semin,	सेमिन,	सेमिन,	
venkatraman,	वेंकटरमण,	वेंकटरमन,	
suljhai,	सुलझाई,	सुलझाई,	
tribunal,	ट्रिबुनल,	ट्रिब्युनल,	
mhantam,	महंतम,	महानतम,	
catlin,	कैटलिन,	कैटलिन,	
vibram,	वाइब्रम,	विभ्रम,	
paakhandi,	पाखंडी,	पाखंडी,	
ravael,	रवैल,	रवैल,	
jeevanshaili,	जीवनशीली,	जीवनशैली,	
jaine,	जैने,	जैने,	
registan,	रेजिस्तान,	रेगिस्तान,	
paheliyaan,	पहललियां,	पहेलियां,	
abaru,	अबारू,	आबरू,	
trijta,	त्रिजता,	त्रिजटा,	
rukate,	रुकते,	रुकते,	
kangan,	कांगन,	कंगन,	
bosan,	बोसनन,	बोसान,	
tonga,	टोंगा,	टोंगा,	
kpada,	कपाड़ा,	कपड़ा,	
bajrangi,	बजरांगी,	बजरंगी,	
flesh,	फ्लैश,	फ्लेश,	
karyabhar,	कार्यभार,	कार्यभार,	
thane,	थाने,	थाणे,	
lakshmidhar,	लक्ष्मीधार,	लक्ष्मीधर,	
roopesh,	रूपेश,	रुपेश,	
dharmnath,	धर्मनाथ,	धर्मनाथ,	
saima,	सैमा,	साइमा,	
gandki,	गंदकी,	गंडकी,	
kanblon,	कांबलों,	कंबलों,	
nadep,	नेडप,	नाडेप,	
sahakalaakar,	सहकालाकर,	सहकलाकार,	
vritton,	वृत्तों,	वृत्तों,	
mod,	मोड,	मॉड,	
lanchar,	लांचर,	लांचर,	
raalod,	रालोड,	रालोद,	
jhalakti,	झलकती,	झलकती,	
polymer,	पॉल्मर,	पॉलिमर,	
item,	इटे,	आइटम,	
rishtey,	रिश्टे,	रिश्ते,	
pratigya,	प्रतिज्ञ,	प्रतिज्ञा,	
dikhayi,	दिखाई,	दिखाई,	
kaushalta,	कौशलता,	कौशलता,	
veronica,	वेरोनिका,	वेरोनिका,	
kisaani,	किसानी,	किसानी,	
maryada,	मररयाा,	मर्यादा,	
dav,	डीववी,	दाव,	
vyavdhan,	व्यवधान,	व्यवधान,	
khudai,	खुदाई,	खुदाई,	
aary,	आर्य,	आर्य,	
khanikarma,	खनिकर्म,	खनिकर्म,	
asphault,	असफॉल्ट,	एस्फाल्ट,	
bouni,	बौनी,	बौनी,	
bosaan,	बोसान,	बोसान,	
parleron,	पारललरों,	पार्लरों,	
piky,	पिकी,	पिकी,	
rais,	रैस,	रईस,	
ear,	इयर,	इअर,	
siddhwat,	सिद्धववत,	सिद्धवट,	
kahane,	कहने,	कहने,	
swaachaalit,	स्वाछालित,	स्वाचालित,	
taja,	ताजा,	ताजा,	
tagade,	तगडेे,	तगड़े,	
dah,	दाह,	दाह,	
gujarna,	गुजरना,	गुजारना,	
jvaron,	ज्वरों,	ज्वारों,	
khal,	खल,	खाल,	
mezbaan,	मेबबान,	मेज़बान,	
najriyon,	नज़रियों,	नजरियों,	
arpit,	अर्पिट,	अर्पित,	
chakshu,	चक्षु,	चक्षु,	
pathshalayein,	पाठशालाएं,	पाठशालाएं,	
karki,	कर्की,	कार्की,	
astin,	एस्तिन,	आस्तीन,	
zamaanaa,	ज़माना,	ज़माना,	
mahkane,	महकाने,	महकने,	
tapmano,	तप्मनों,	तापमानों,	
manjilein,	मानजीलें,	मंजिलें,	
senvai,	सेनवाई,	सेंवई,	
jivanshaili,	जीवनशेली,	जीवनशैली,	
lahsun,	लहसून,	लहसुन,	
parimal,	परिमाल,	परिमल,	
karykartaon,	कार्यककत्ताओं,	कार्यकर्ताओं,	
piloton,	पिलोटों,	पायलटों,	
paarampariktaa,	पारंपरिकता,	पारंपरिकता,	
tarko,	तार्को,	तर्कों,	
chikitsak,	चिकित्सक,	चिकित्सक,	
ank,	एंक,	अंक,	
sandhan,	संधधन,	संधान,	
kapdi,	कपड़ी,	कापड़ी,	
nanaa,	नाना,	नना,	
betul,	बेतुल,	बैतूल,	
chanan,	चनन,	चानन,	
aavishakaar,	आविष्कार,	आविष्कार,	
dhakal,	ढकाल,	ढकाल,	
sipah,	सिपाह,	सिपाह,	
harna,	हरना,	हारना,	
kankar,	कांकर,	कंकड़,	
sanghanit,	सांघनित,	संघनित,	
waan,	वान,	वाण,	
naxali,	नकली,	नक्सली,	
dikhaiye,	दिखाइए,	दिखाइये,	
dhoondhata,	ढूंधकाता,	ढूंढता,	
peary,	पीरी,	पियरी,	
andreas,	एंड्रेज,	एंड्रियास,	
maason,	मासों,	मासों,	
fatane,	फटने,	फटने,	
uplakshay,	उपलकक्षय,	उपलक्ष्य,	
durghatna,	दुर्घटता,	दुर्घटना,	
yashpal,	यशप्ल,	यशपाल,	
tiron,	तीरोन,	तीरों,	
mowgli,	मागली,	मोगली,	
dhoron,	धोरों,	धोरों,	
chakkar,	चक्कर,	चक्कर,	
warriors,	वेरियर्स,	वारियर्स,	
mangesh,	मंगेश,	मंगेश,	
sliders,	स्लाइडर्स,	स्लाइड्स,	
busy,	बस्,	बिजी,	
quete,	क्वेट,	क्यूट,	
brant,	ब्रंट,	भ्रांत,	
sexual,	सेक्व्ल,	सेक्सुअल,	
risne,	रिसने,	रिसने,	
agsta,	अग्सता,	अगस्ता,	
yada,	यादा,	यदा,	
tennis,	टेनिस,	टेनिस,	
shanghai,	शांघाई,	शंघाई,	
rakhe,	रखे,	राखे,	
parosne,	परोसने,	परोसने,	
shaun,	शौन,	शॉन,	
kanal,	कााल,	कनाल,	
veeresh,	वीरेश,	वीरेश,	
bhuswami,	भूस्वामी,	भूस्वामी,	
achievement,	अक्ववमेंट,	अचीवमेंट,	
synapse,	सिनेपेस,	सिनेप्स,	
malaga,	मलागा,	मलागा,	
rumani,	रूमानी,	रुमानी,	
amargad,	अमरगाड़,	अमरगढ़,	
pashtun,	पाष्टुर,	पश्तून,	
chamkana,	चमकाना,	चमकना,	
aanand,	आनंद,	आनद,	
ashrafi,	अश्रफी,	अशरफी,	
maariyo,	मारियो,	मारियो,	
galaxiyon,	गैलकियों,	गैलेक्सियों,	
manchit,	मानछित,	मंचित,	
sanskrutiyon,	संस्कृतियों,	संस्कृतियों,	
taboo,	ताबू,	टैबू,	
raghupati,	रघुपति,	रघुपति,	
junagarh,	जूनागढ़,	जूनागढ,	
jin,	जिन,	जीन,	
mancheeye,	मंचिय,	मंचीय,	
gandaki,	गंदकी,	गंडकी,	
dayityon,	दायित्यों,	दायित्वों,	
atkata,	अत्कता,	अटकता,	
sanyogvash,	संयोग्वशश,	संयोगवश,	
badhaaon,	बढ़ाओं,	बाधाओं,	
mahinon,	महहनों,	महीनों,	
vediyon,	वेदियों,	वेदियों,	
rugan,	रूग्ण,	रुग्ण,	
khatakti,	खटकती,	खटकती,	
truck,	ट्रक,	ट्रक,	
jwar,	ज्वर,	ज्वार,	
angreji,	अग्रेजी,	अंग्रज़ी,	
carfi,	कार्फी,	कार्की,	
gulshan,	गुलशान,	गुलशन,	
mega,	मेगा,	मेगा,	
janagananaa,	जागगना,	जनगणना,	
sonpne,	सौंपने,	सौंपने,	
majin,	माजिन,	माजिन,	
mubarkpur,	मुबर्पुर,	मुबारकपुर,	
ladaeyon,	लड़ायों,	लड़ाईयों,	
nipatara,	निपटररा,	निपटारा,	
dulne,	डूलने,	डुलने,	
mushahid,	मुषाहिद,	मुशाहिद,	
vardhman,	वर्धमान,	वर्द्धमान,	
trimasik,	त्रिमासिक,	त्रैमासिक,	
harvansh,	हार्ंंश,	हरवंश,	
rese,	रेस,	रेस,	
select,	सेलेक्ट,	सलेक्ट,	
shrunkhla,	शृंखला,	श्रंखला,	
aurora,	औरोरा,	औरोरा,	
mungeri,	मुंगेरी,	मुंगेरी,	
sohaval,	सोहवाल,	सोहावल,	
harpaal,	हरपाल,	हरपाल,	
amarpal,	अमरपाल,	अमरपाल,	
awazon,	आवाजों,	आवाज़ों,	
shahdara,	शहहदरा,	शहादरा,	
rangkata,	रंगकता,	रंजकता,	
vyagr,	व्याग्र,	व्यग्र,	
swaroopon,	स्वरूपों,	स्वरुपों,	
naagrik,	नागरिक,	नागारिक,	
poker,	पॉकर,	पोकर,	
beerganj,	बीरगंज,	बीरगंज,	
khattapan,	खट्टापन,	खट्टापन,	
ishara,	इशारा,	इशारा,	
lehrayi,	लहरायी,	लहराई,	
bharni,	भरनी,	भरनी,	
spray,	स्प्रयय,	स्प्रे,	
ulemaon,	उल्मेमाओं,	उलेमाओं,	
vatanukulan,	वातानुकालन,	वातानुकूलन,	
form,	फॉर्म,	फार्म,	
kant,	कांत,	कांट,	
shatpath,	शट्थाठ,	शतपथ,	
dayitvon,	दययित्वों,	दायित्वों,	
prashikshu,	प्रशिक्षु,	प्रशिक्षु,	
lenset,	लेंसेट,	लैंसेट,	
narayangadh,	नारायंगढ़,	नारायणगढ़,	
angrzi,	अंगर्जी,	अंग्रज़ी,	
bhoonhon,	भूनों,	भौंहों,	
beast,	बीस्ट,	बीस्ट,	
regal,	रेगल,	रीगल,	
laurens,	लॉरेंस,	लौरेंस,	
aparivartansheel,	अपरिवत्रशील,	अपरिवर्तनशील,	
bhogte,	भोगते,	भोगते,	
kasrat,	कसरत,	कसरत,	
beaulad,	ब्यूल्ड,	बेऔलाद,	
bodra,	बोडरा,	बोदरा,	
jaino,	जैनो,	जैनों,	
tenin,	टेनिन,	टैनिन,	
hurricane,	हुरिकेनन,	हरिकेन,	
udharv,	उधार्व,	ऊर्ध्व,	
dangon,	डांगों,	दंगों,	
sanskari,	संस्करी,	संस्कारी,	
ghataatop,	घटातोप,	घटाटोप,	
pran,	प्रण,	प्राण,	
dhokebaz,	धोकेबाज,	धोखेबाज,	
anik,	अनिक,	अनिक,	
poonjikaran,	पूंजीकरण,	पूंजीकरण,	
swa,	स्वा,	स्वा,	
navate,	नवाते,	नवाते,	
parabola,	पररबोला,	पैराबोला,	
manzilein,	मांजललें,	मंजिलें,	
machano,	मचानों,	मचानों,	
banam,	बनाम,	बनाम,	
najarandaaz,	नज़रंदाज़,	नजरंदाज,	
samuels,	सम््यूल्स,	सैम्युल्स,	
ibiza,	इबीज़ा,	इबीजा,	
durdhara,	दुर्धारा,	दरदरा,	
cement,	सीमेंट,	सिमटे,	
takaraon,	टकराओं,	टकरावों,	
nihaalchand,	निहालचंद,	निहालचंद,	
jeeyo,	जीयो,	जीयो,	
bahuly,	बहुल्ले,	बाहुल्य,	
dampatiyon,	दंपतितोयों,	दंपतियों,	
chink,	चींक,	छींक,	
chhajan,	छजन,	छाजन,	
live,	लाइव,	लाईव,	
prativad,	प्रतिवाद,	प्रतिवाद,	
anurit,	अनुरीत,	अनुरीत,	
wlaad,	वलाद,	व्लाद,	
wise,	वाइस,	वाइज,	
tapoowo,	टैपूवो,	टापुओं,	
sunaaron,	सुनारों,	सुनारों,	
dukhan,	दुखन,	दुखन,	
abut,	अबूत,	एबट,	
supachye,	सुपा्च,	सुपाच्य,	
ovum,	ओवम,	ओवम,	
kamaljeet,	कमलजीत,	कमलजीत,	
aulakh,	औलख,	औलख,	
bharatnatyam,	भारतनात्मम,	भरतनाट्यम्,	
dhuan,	धुनआ,	धुआं,	
udant,	उदांत,	उदंत,	
shringaar,	श्रृंगार,	शृंगार,	
queens,	क्वींस,	क्वींस,	
surinama,	सुरीनामा,	सूरीनाम,	
sweccha,	स्वेच्छा,	स्वेच्छा,	
pooranpur,	पुराणपुर,	पूरनपुर,	
paathyakram,	पाठ्यक्रम,	पाठ्यक्रम,	
end,	एंड,	ऐंठ,	
chithrkar,	चित्रकर,	चित्रकार,	
aakaash,	आकाश,	आकाश,	
karachana,	कररचना,	करछना,	
khaskar,	खस्कर,	ख़ासकर,	
ghabrahat,	घब्रहात,	घबराहट,	
offshor,	ऑफफ,	ऑफशोर,	
bachat,	बचात,	बचत,	
royals,	रोयलल्स,	रॉयल्स,	
raajasva,	राजसवा,	राजस्व,	
orion,	ओरियन,	ओरियन,	
salaahkar,	सलाखकर,	सलाहकार,	
sajan,	सजन,	साजन,	
racketeer,	रैकीटरर,	रैकेटियर,	
narmi,	नर्मम,	नरमी,	
nikhari,	निखरी,	निखरी,	
laksar,	लक्सर,	लक्सर,	
saleeb,	सलीब,	सलीब,	
drupad,	द्रुपद,	ध्रुपद,	
antah,	अंताह,	अंतः,	
bahav,	बहाव,	बहाव,	
higman,	हिगमन,	हाइमन,	
vigyaanon,	विज्ञानों,	विज्ञानों,	
aahnan,	आहनन,	आह्नान,	
sansthit,	संस्थित,	संस्थित,	
shravani,	श्रवनन,	श्रावणी,	
nehra,	नेहरा,	नेहरा,	
ashriri,	अश्रीरी,	अशरीरी,	
gutta,	गुटता,	गुट्टा,	
bethanal,	बेथनाल,	बेथनल,	
belacha,	बेलचा,	बेलचा,	
halchaal,	हलचाल,	हालचाल,	
varn,	वर््,	वर्ण,	
raghuram,	रघुररम,	रघुराम,	
navketan,	नवकेतन,	नवकेतन,	
bare,	बारे,	बरे,	
putli,	पुटली,	पुतली,	
bosten,	बोस्टन,	बॉस्टन,	
bagbani,	बागबानी,	बागबानी,	
tungnath,	तूंगनाथ,	तुंगनाथ,	
tyohar,	त्योहार,	त्यौहार,	
registerd,	रेजि्टर्ड,	रजिस्टर्ड,	
ipad,	ईपाद,	आईपैड,	
dikhaai,	दिखाई,	दिखाईं,	
kahne,	कहने,	कहने,	
pranon,	प्रणों,	प्राणों,	
psv,	पीएसवी,	पीएसवी,	
urvarta,	उर्वतरता,	उर्वरता,	
jenee,	जेनी,	जेनी,	
meharaam,	मेहराम,	मेहराम,	
badhachadhakar,	बढ़धाकार,	बढ़ाचढ़ाकर,	
nitiyon,	नितियों,	नीतियों,	
mahakne,	महकने,	महकने,	
ballabh,	बल्लभ,	बल्लभ,	
ccd,	सीसीडी,	सीसीडी,	
dubana,	डूबनना,	डुबाना,	
yojanaye,	योजनाए,	योजनाएं,	
sweet,	स्वीत,	स्वीट,	
pakaayein,	पकाएं,	पकाएं,	
sujain,	सुजाईं,	सुजैन,	
lakhkhi,	लखखखी,	लख्खी,	
hoshangabaad,	होषनाबााबड़,	होशंगाबाद,	
velkan,	वेलकन,	वल्कन,	
khapat,	खपट,	खपत,	
mundwa,	मुंडवा,	मुंडवा,	
chkkar,	चक्कार,	चक्कर,	
uchhalne,	उछालने,	उछालने,	
sawaal,	सवाल,	सवाल,	
naksalavaad,	नक्सलवाद,	नक्सलवाद,	
machae,	मचाई,	मचाए,	
yaduvansh,	यदुवंंश,	यदुवंश,	
saabah,	साबाह,	साबाह,	
amdi,	अमदी,	आमदी,	
nelson,	नेल्सन,	नेल्सन,	
sarsaa,	सरसा,	सरसा,	
ludhakate,	लुढ़कते,	लुढ़कते,	
dampati,	दामपति,	दंपति,	
juloos,	जुलूस,	जूलूस,	
shrabon,	शररबों,	शराबों,	
pilot,	पिलोट,	पायलट,	
vyaghat,	व्याघात,	व्याघात,	
watson,	वा्सन,	वाटसन,	
thaki,	थकी,	थकी,	
tuglak,	तुग्लक,	तुगलक,	
talabgar,	तालबगार,	तलबगार,	
nominate,	नोमिनेट,	नॉमिनेट,	
farookhnagar,	फरुख्नगर,	फर्रूखनगर,	
theatron,	थित्रों,	थिएटरों,	
sargana,	सरगना,	सरगना,	
charts,	चार्ट्स,	चार्ट्स,	
pyade,	प्याद,	प्यादे,	
davidson,	डेविड्सन,	डेविडसन,	
manchiya,	मांचिया,	मंचीय,	
jadet,	जादेत,	जड़ित,	
louis,	लुई,	लुईस,	
nitya,	नित्य,	नित्या,	
anton,	एंटन,	एंटोन,	
jadd,	जद्द,	जड़,	
teeron,	टीरों,	तीरों,	
vidhansabhaein,	विधानसंायं,	विधानसभाएं,	
de,	दे,	डीई,	
gemhagehmi,	गेहहगमही,	गहमागहमी,	
bakayon,	बकायों,	बकायों,	
vellur,	वेलरर,	वेल्लूर,	
ryan,	र्यान,	रयान,	
anand,	आनंद,	आनद,	
shumali,	शुमाली,	शुमाली,	
ftii,	फ्टीई,	एफटीआईआई,	
bulletin,	बुलेटीन,	बुलेटिन,	
chhagla,	छगला,	छागला,	
adhivas,	अधिवास,	अधिवास,	
basil,	बेसिल,	बेसिल,	
muhavre,	मुहावरे,	मुहावरे,	
ikvitija,	इक्वितीजा,	इक्विटीज,	
aprihary,	अपरिहार्य,	अपरिहार्य,	
offshore,	ऑफफोर,	ऑफशोर,	
anavshyak,	अनावश्यक,	अनावश्यक,	
awaazon,	आवाजों,	आवाज़ों,	
cant,	कैंट,	कांट,	
dikhaaee,	दिखाई,	दिखाईं,	
vineet,	विनीत,	विनीत,	
bikaner,	बिकननर,	बीकानेर,	
hijda,	हिजड़ा,	हिजड़ा,	
devapur,	देवापुर,	देवापुर,	
roosevelt,	रूज़वेललट,	रुजवेल्ट,	
ubaal,	उबाल,	उबाल,	
chanwal,	चानवाल,	चांवल,	
akhand,	अखंंड,	अखंड,	
rojlin,	रोजलीन,	रोजलिन,	
simatataa,	सिमतता,	सिमटता,	
shasakon,	शासकों,	शासकों,	
sambhalane,	संभालने,	संभालने,	
devaapur,	देवापुर,	देवापुर,	
vidhaaein,	विधाएं,	विद्याएं,	
chhupkar,	छुपकार,	छुपकर,	
oklahoma,	ओकोलहोमि,	ओकलाहोमा,	
badhav,	बढ़ाव,	बढ़ाव,	
gomake,	गोमके,	गोमके,	
julaahon,	जुलाहों,	जुलाहों,	
sapramaan,	सप्रमाण,	सप्रमाण,	
sthul,	स्थल,	स्थूल,	
avarodhak,	अवरोधक,	अवरोधक,	
dali,	दली,	दली,	
mulchand,	मूलचंद,	मूलचंद,	
kalika,	कालिका,	कलिका,	
huin,	हाइं,	हुईं,	
prapt,	प्राप्त,	प्राप्त,	
karanj,	कराज,	करंज,	
nrutyon,	नृत्यों,	नृत्यों,	
liberation,	लिब्रेशन,	लिबरेशन,	
pachata,	पचाता,	पचाता,	
baarahamaasee,	बारहामसी,	बारहमासी,	
aazmaanaa,	आजमाना,	आजमाना,	
gahmagahmi,	गहहमग्ही,	गहमागहमी,	
kutta,	कुट्त,	कुत्ता,	
half,	हाफ,	हॉफ,	
gayatri,	गयात्री,	गायत्री,	
sirhind,	सीरहिंड,	सरहिंद,	
awaazen,	आवाजें,	आवाज़ें,	
pangolin,	पांगोलिन,	पैंगोलिन,	
brigatn,	ब्रिगटन,	ब्रिगटन,	
mhanideshak,	महानिदेशक,	महानिदेशक,	
janganna,	जंगाना,	जनगणना,	
parikhaen,	परिखाएं,	परीक्षाएं,	
dhuriyaa,	धुरिया,	धुरिया,	
mahanatam,	महानतम,	महानतम,	
bharakaya,	भड़काया,	भड़काया,	
tugalaki,	तुगलाकी,	तुगलकी,	
shawn,	शान,	शॉन,	
maine,	मैइन,	मैने,	
audyogikikaran,	औद्योगिकीकरण,	औद्योगिकरण,	
vishwasaniy,	विश्वसनीय,	विश्वसनीय,	
velvet,	वेलवेट,	वेलवेट,	
vajud,	वजुद,	वजूद,	
churcha,	चर्चा,	चर्चा,	
aliens,	एलिंस,	एलियंस,	
suhagin,	सुहागीन,	सुहागिन,	
ravaley,	रवाले,	रावले,	
urwarta,	उर्वरता,	उर्वरता,	
kasht,	काष्ट,	काश्त,	
alii,	एली,	अली,	
cateline,	कैटलीन,	कैटलिन,	
pidiya,	पीढ़िया,	पीडिया,	
lakeer,	लकीीर,	लकीर,	
jhankna,	झानका,	झांकना,	
thaharne,	ठहरने,	ठहरने,	
najeem,	नजीम,	नजीम,	
apvartit,	अपवर्ततित,	अपवर्तित,	
karna,	कारना,	करना,	
wanon,	वानों,	वाणों,	
navvadhoo,	नवववधू,	नववधू,	
shayak,	शयक,	शायक,	
chaplusi,	चापलूसी,	चापलूसी,	
sandali,	सांडली,	संदली,	
prem,	प्रैम,	प्रेम,	
kabra,	काबरा,	कब्र,	
orian,	ओरियन,	ओरियन,	
saym,	सायम,	सायं,	
lindbhed,	लिंडहहेड,	लिंगभेद,	
chauki,	चौकी,	चौकी,	
ikatthi,	इकट्ठी,	इकठ्ठी,	
yaduwansh,	यदुवंंश,	यदुवंश,	
augustustine,	अगस्टस्टिनी,	अगस्टाइन,	
wonder,	वानडर,	वंडर,	
vardhmaan,	वर्धमान,	वर्द्धमान,	
naxal,	नककल,	नक्सल,	
bheed,	भिड़,	भीड़,	
samanvayaka,	समन्वयका,	समन्वयक,	
achhanera,	अचनेेरा,	अछनेरा,	
vanshvaad,	वंशववाद,	वंशवाद,	
karghe,	कार्ेे,	करघे,	
dubana,	डूबनना,	डूबना,	
salib,	सलीब,	सलीब,	
niyaa,	निया,	निया,	
introduction,	इंट्रोक्शनशन,	इंट्रोडक्शन,	
neelagaay,	नीलागय,	नीलगाय,	
reson,	रेसों,	रेसों,	
ramkote,	रामकोत,	रामकोट,	
jaibaan,	जाईबान,	जयबाण,	
samprati,	संप्रति,	संप्रति,	
vaishakhi,	वैशाखी,	वैशाखी,	
haraval,	हरावल,	हरावल,	
eddi,	एडी,	एड्डी,	
phoda,	फोडा,	फोड़ा,	
sitaram,	सीतारम,	सीताराम,	
padhaa,	पढ़ा,	पढ़ा,	
pravatti,	प्रवत्ति,	प्रवत्ति,	
time,	टीमम,	टाइम,	
aerobics,	एेरॉबिक्स,	एरोबिक,	
farrukhabad,	फररुखाबड़,	फर्रुखाबाद,	
vaanon,	वानों,	वाणों,	
carat,	कारट,	कैरेट,	
nikalegi,	निकालेगी,	निकलेगी,	
pintaa,	पिंटा,	पिंटा,	
ripan,	रिपन,	रिपन,	
sipahiyon,	सीपाहियों,	सिपाहियों,	
prastaavon,	प्रस्तावों,	प्रस्तावों,	
badhaataa,	बढ़ाता,	बढ़ाता,	
sfc,	एसएफसी,	एसएफसी,	
formuley,	फॉर्मूलू,	फार्मूले,	
aviva,	अविवा,	अवीवा,	
lambi,	लंबी,	लंबी,	
cutlery,	कटरी,	कटलरी,	
jaankaaron,	जानकारों,	जानकारों,	
jurab,	जुराब,	जुराब,	
pide,	पीइड,	पाइड,	
kaldwell,	कल्ववेल,	काल्डवेल,	
avarnataa,	अवर्णता,	अवर्णता,	
naasar,	नासर,	नासर,	
sanyukta,	सानुयक्त,	संयुक्त,	
chinke,	चिंके,	छींके,	
shaavakon,	शावकों,	शावकों,	
ganpati,	गणपती,	गणपति,	
nilgai,	निलगाई,	नीलगाय,	
updravion,	उप््रववयों,	उपद्रवियों,	
padmavati,	पद्मावती,	पदमावती,	
ratanpur,	रतनपुर,	रतनपुर,	
shrart,	शरर्त,	शरारत,	
chidhte,	चिढ़ते,	चिढ़ते,	
samaadhaan,	समाधान,	समाधान,	
juber,	ज़ुबैर,	जुबेर,	
libration,	लाइब्रेशन,	लिबरेशन,	
data,	डाटा,	दाता,	
fodon,	फोड़ों,	फोड़ों,	
qawwaliyon,	क़व्वालियों,	कव्वालियों,	
chidchidapan,	चिड़चिड़ापन,	चिड़चिड़ापन,	
patiyaa,	पटिया,	पटिया,	
roopak,	रुपक,	रूपक,	
friendship,	फ्रेंडिंप,	फ्रेंडशिप,	
rupesh,	रुपेश,	रुपेश,	
las,	लास,	लास्ट,	
ainthey,	ऐंठे,	ऐंठे,	
maariya,	मारिया,	मारिया,	
barat,	बारात,	बरात,	
narnari,	नारनारी,	नरनारी,	
ghasi,	घसी,	घासी,	
aryon,	अर्योन,	आर्यों,	
lata,	लता,	लाता,	
chhupata,	छुपडाा,	छुपता,	
phatane,	फटने,	फटने,	
dhaagaa,	ढागा,	धागा,	
singha,	सिंघा,	सिंहा,	
jaatiyon,	जातियों,	जातियों,	
bisawan,	बीसवान,	बीसवां,	
punjabiyon,	पूंजाबियों,	पंजाबियों,	
jatra,	जातरा,	जतरा,	
privacy,	प्रिवेसी,	प्राइवेसी,	
nishnaat,	निश्णात,	निष्णात,	
pahlaa,	पहला,	पहला,	
caitlyn,	कैटलीन,	कैटलिन,	
chaalit,	चालित,	चालित,	
bag,	बाग,	बीएजी,	
dhaatuyein,	धातुएं,	धातुएं,	
salahkaar,	सलाकार,	सलाहकार,	
sanbharnt,	संभर्त,	संभ्रांत,	
tariko,	तारिको,	तरीको,	
theater,	थिटर,	थियेटर,	
rajon,	रजों,	राजों,	
wed,	वेड,	वेड,	
sphoorti,	स्फूर्ति,	स्फूर्ति,	
alankaron,	अलंकरों,	अलंकारों,	
atwal,	अट्वल,	अटवाल,	
puna,	पूना,	पुना,	
mardo,	मार्डो,	मर्दों,	
roya,	रोया,	रोया,	
xm,	एसएमए,	एक्सएम,	
aavritti,	आवृत्ति,	आवृत्ति,	
colan,	कॉलन,	कोलन,	
follow,	फोलो,	फ़ॉलो,	
prarup,	प्ररूप,	प्रारूप,	
baalti,	बालती,	बाल्टी,	
raadhe,	राढ़े,	राधे,	
varna,	वर्ा,	वर्ण,	
aden,	एडेन,	एडेन,	
bhogatey,	भोगते,	भोगते,	
greg,	ग्रेग,	ग्रेग,	
bhulo,	भुलो,	भूलो,	
prardashan,	प्रदरदाशन,	प्रर्दशन,	
sochne,	सोचने,	सोचने,	
vishnu,	विष्णु,	विष्णु,	
amuk,	अमूक,	अमुक,	
simi,	सीमी,	सिमी,	
nadsa,	नद्सा,	नक्सल,	
uplabdhiyon,	उपलबबियों,	उपलब्धियों,	
mukhopadhyaya,	मुखोख्ध्याय,	मुखोपाध्याय,	
melaani,	मेलानी,	मेलानी,	
dark,	डार्क,	डॉर्क,	
racketier,	रैकीटीर,	रैकेटियर,	
vincent,	विंसेंट,	विंसेंट,	
pythagoras,	पिथाागररस,	पाइथागोरस,	
kshetron,	क्षेेत्ररो,	क्षेत्रों,	
aayenge,	आयंगे,	आयेंगे,	
stress,	स्ट्रेस,	स्ट्रास,	
kisani,	किसनी,	किसानी,	
kabren,	कबरें,	कब्रें,	
prtigyaa,	प्रतिज्ञा,	प्रतिज्ञा,	
phalibhoot,	फलीलूभ,	फलीभूत,	
tarabganj,	तराबगंज,	तरबगंज,	
sim,	सिम,	सीम,	
baadhaaon,	बाधाओं,	बाधाओं,	
paheliyon,	पहेलियों,	पहेलियों,	
agusta,	अगुस्त,	अगस्ता,	
gaanthe,	गांथे,	गांठे,	
soond,	सूंड,	सूंड़,	
shipra,	शिप्र,	शिप्रा,	
pv,	पीवी,	पीवी,	
maurya,	मौर्य,	मौर्या,	
jyotiba,	ज्योतिबा,	ज्योतिबा,	
sims,	सिम्स,	सिम्स,	
ganth,	गंंथ,	गांठ,	
mahlon,	महलों,	महलों,	
manto,	मानटो,	मंटो,	
fandon,	फांदों,	फंदों,	
duwaidhaayein,	दुवैधाएं,	दुविधाएं,	
agyaat,	अज्ञात,	अज्ञात,	
bodara,	बोदरा,	बोदरा,	
shaao,	शाओ,	शाओ,	
bhengapan,	भेंगपन,	भेंगापन,	
baapaa,	बापा,	बापा,	
niyantaa,	नियंता,	नियंता,	
to,	तो,	तो,	
mukhyopadhyaay,	मुख्योप्याध्य,	मुखोपाध्याय,	
bim,	बीम,	बीम,	
pushpa,	पुष्प,	पुष्प,	
sakra,	सकरा,	सकरा,	
unthak,	उंथक,	अनथक,	
egmor,	एजमोर,	एगमोर,	
gross,	ग्रॉस,	ग्रॉस,	
pale,	पले,	पले,	
dhaari,	धारी,	धारी,	
teekon,	टीकों,	टीकों,	
sahrawat,	सहरावत,	सहरावत,	
hong,	होंग,	हॉन्ग,	
locket,	लॉकट,	लॉकेट,	
granthiyaan,	ग्रंथियां,	ग्रंथियां,	
ronaldo,	रोनाल्डो,	रोनाल्डो,	
chauguni,	चौगुनी,	चौगुनी,	
dhona,	ढोना,	धोना,	
balti,	बालती,	बाल्टी,	
bhugol,	भूगोल,	भूगोल,	
pammi,	पम्मी,	पम्मी,	
bombi,	बोंबी,	बांबी,	
chachaji,	चाखा,	चाचाजी,	
upneta,	उपनेता,	उपनेता,	
jobs,	जॉब्स,	जॉब्स,	
ubhara,	उभरा,	उभारा,	
abhimat,	अभिमात,	अभिमत,	
bikherti,	बिखेरती,	बिखेरती,	
ghisi,	घिसी,	घिसी,	
maratha,	मररथा,	मराठा,	
mahathir,	महाहिर,	महाथिर,	
trebal,	ट्रेबल,	ट्रेबल,	
sparivar,	स्परिवार,	सपरिवार,	
dhonaa,	ढोना,	धोना,	
uplabdhi,	उपलबबी,	उपलब्धी,	
apardarshi,	अपररदश्,	अपारदर्शी,	
khaen,	खाएं,	खाएं,	
asamaany,	असामान्य,	असमान्य,	
masoor,	मसूर,	मसूर,	
sipaha,	सीपाहा,	सिपाह,	
awaru,	अवारु,	अवरु,	
christian,	क्रिस्चियन,	क्रिश्चयन,	
urfa,	उर्फा,	उर्फ,	
sirpur,	सिरपुर,	सिरपुर,	
bavji,	बावजी,	बावजी,	
rakhna,	रखना,	रखना,	
praudh,	प्रौढ़,	प्रौढ,	
udana,	उड़ना,	उड़ाना,	
slidon,	स्लाडनन,	स्लाइडों,	
raktaabh,	रक्ताभ,	रक्ताभ,	
naam,	नाम,	नाम,	
sudhaargrah,	सुधारगारह,	सुधारगृह,	
kaetholikon,	कैथोलिकों,	कैथोलिकों,	
daataa,	दाता,	दाता,	
baraamad,	बरामद,	बरामद,	
gosvaami,	गोस्वामी,	गोस्वामी,	
gene,	जेने,	जैने,	
naxaliyon,	नक्ललियों,	नक्सलियों,	
baag,	बाग,	बाग,	
kagaj,	कागज,	कागज़,	
simmons,	सिममंस,	साइमंस,	
aalochak,	आलोचक,	आलोचक,	
neco,	नेको,	नेको,	
punjikaran,	पूंजीकरण,	पूंजीकरण,	
chlenge,	चेलेंज,	चलेंगे,	
chhaapemaar,	छापेमार,	छापेमार,	
regional,	रेजनलल,	रीजनल,	
taobao,	तोबा,	टैबू,	
kakoo,	काकू,	काकू,	
sharmana,	शर्मना,	शर्माना,	
packagon,	पैककों,	पैकेजों,	
neg,	नेग,	नेग,	
ambani,	अमबानी,	अंबानी,	
avishkar,	अविष्कार,	आविष्कार,	
depthiriya,	देप्थिरिय,	डिप्थीरिया,	
timer,	टाइमर,	टाइमर,	
sheershakon,	शीरककों,	शीर्षकों,	
tuberculosis,	टुब्बरक्लिसस,	ट्यूबरक्यूलोसिस,	
ghuman,	घूमान,	घुमाण,	
karyarat,	कार्यारत,	कार्यरत,	
amitav,	अमितव,	अमिताव,	
vrutton,	वृत्तों,	वृत्तों,	
narbhakshi,	नारभक्षी,	नरभक्षी,	
bnaam,	बनाम,	बनाम,	
maange,	मांगे,	मांगे,	
nagine,	नागीन,	नगीने,	
devi,	देवी,	देवी,	
sanghnit,	सांघनित,	संघनित,	
sapne,	सपने,	सपने,	
aavriti,	आवृति,	आवृत्ति,	
fawaara,	फवाररा,	फव्वारा,	
hupper,	हपप्र,	हूपर,	
ekthi,	इक्ठी,	इकठ्ठी,	
apaardarshi,	अपारदर्शी,	अपारदर्शी,	
cigaretton,	सिगरेटों,	सिगरेटों,	
kusumlata,	कुसुमलता,	कुसुमलता,	
singaar,	सिंगार,	सिंगार,	
oceanic,	ऑसीनिक,	ओशनिक,	
sanskrutiyan,	संस्कृतियां,	संस्कृतियां,	
vartman,	वार्तमैन,	वर्तमान,	
yuddhrat,	युद्धरात,	युद्धरत,	
batlaye,	बतलाए,	बतलाए,	
cpm,	सीपीएम,	सीपीएम,	
kanindham,	कननिंधम,	कनिंघम,	
wangchuk,	वागचुक,	वांगचुक,	
baji,	बाजी,	बाज़ी,	
vyatit,	व्यतित,	व्यतीत,	
ulate,	उलाते,	उलटे,	
chahunaur,	चुुननौर,	चहुंओर,	
nikalni,	निकालनी,	निकालनी,	
nirdeshika,	निर्देशिका,	निर्देशिका,	
pagla,	पगला,	पगला,	
shakhayen,	शाखाएं,	शाखाएं,	
kihatkati,	किहकतती,	खटकती,	
phabti,	फबती,	फब्ती,	
nau,	नौ,	नाऊ,	
samprbhu,	संपरभभ,	संप्रभु,	
narm,	नर्म,	नरम,	
mahantam,	महानता,	महानतम,	
sonu,	सोनू,	सोनू,	
labeling,	लेबेलिंग,	लेबलिंग,	
mantriyon,	मंत्रियों,	मंत्रियों,	
simat,	सीमतत,	सिमट,	
suljaayi,	सुलझाई,	सुलझाई,	
praan,	प्राण,	प्राण,	
seem,	सीम,	सीम,	
jagaega,	जगाएगा,	जगाएगा,	
dikhayi,	दिखाई,	दिखायी,	
veerchand,	वीरचंड,	वीरचंद,	
sherawat,	शेरावत,	सहरावत,	
drame,	ड्रेम,	ड्रामे,	
enthe,	ईंठे,	ऐंठे,	
beesavaan,	बीसवां,	बीसवां,	
ajit,	अजीत,	अजित,	
swarthparak,	स्वार्थपारक,	स्वार्थपरक,	
mehman,	मेहमान,	मेहमान,	
khurpaka,	खुरपका,	खुरपका,	
sujan,	सूजन,	सुजेन,	
datson,	दत्सों,	डैटसन,	
patachep,	पैठेेप,	पटाक्षेप,	
pahnaakar,	पहनाकर,	पहनाकर,	
ski,	सीकी,	स्की,	
enth,	ईंठ,	ऐंठ,	
sanketik,	सांकेतिक,	सांकेतिक,	
nazarandaz,	नज़रंदाज़,	नजरंदाज,	
virchand,	वीरचंड,	वीरचंद,	
bung,	बूंग,	बंग,	
dikhlaa,	दिखला,	दिखला,	
ayodhyaanaath,	अयोध्यानाथ,	अयोध्यानाथ,	
tonic,	टोनिक,	टॉनिक,	
bakaayon,	बकायों,	बकायों,	
diya,	दिया,	दीया,	
wastinghouse,	वास्इनंहस,	वेस्टिंगहाउस,	
jaatkon,	जातकों,	जातकों,	
gujarte,	गुजरते,	गुजारते,	
bechakar,	बेचकर,	बेचकर,	
kanyaein,	कन्याएं,	कन्याएं,	
patkathayen,	पटकथाएं,	पटकथाएं,	
shrikhand,	श्रीखंड,	श्रीखंड,	
avi,	एवी,	अवि,	
amarpaal,	अमरपाल,	अमरपाल,	
vyaktigat,	व्यक्तिगत,	व्यक्तिगत,	
bevkufana,	बेवकूफना,	बेवकूफाना,	
jaatakon,	जातकों,	जातकों,	
jaatak,	जाटक,	जातक,	
noobiyaa,	नूबिया,	नूबिया,	
tark,	तार्क,	तर्क,	
khurapka,	खुरप्का,	खुरपका,	
mamuli,	मामूली,	मामूली,	
ritual,	रितुअल,	रिचुअल,	
atakta,	अतक्ता,	अटकता,	
aalhaa,	आल्हा,	आल्हा,	
mang,	मांग,	मांग,	
ester,	एस्टर,	एस्टर,	
mahanirdeshak,	महानिर्देशक,	महानिदेशक,	
saval,	सवाल,	सवाल,	
pharma,	फर्मा,	फार्मों,	
janjagran,	जनजाग्रण,	जनजागरण,	
marriage,	मैरिजे,	मैरेज,	
rp,	आरपी,	आरपी,	
lahlahaati,	लहलहाटी,	लहलहाती,	
moryon,	मोर्यों,	मौर्यों,	
najron,	नज़रों,	नजरों,	
bhulta,	भुलता,	भूलता,	
arthon,	अर्थों,	अर्थों,	
sankhyaen,	संख्याएं,	संख्याएं,	
label,	लेबल,	लेबल,	
umanath,	उमानाथ,	उमानाथ,	
talbagar,	तालबगर,	तलबगार,	
achyut,	अछ्युत,	अच्युत,	
upadravi,	उपाद्वी,	उपद्रवी,	
aadan,	आड़न,	आदान,	
duke,	डुके,	ड्यूक,	
tahkhana,	तहखाना,	तहखाना,	
jerusalem,	जेरूसलम,	येरुशलम,	
usak,	उसक,	उसक,	
mauryon,	मौर्यों,	मौर्यों,	
endometrial,	एंडोमेट्रियल,	एंडोमेट्रियल,	
dhale,	ढाले,	ढले,	
rasaayanik,	रसायनिक,	रसायनिक,	
pick,	पिक,	पिक,	
coldvel,	कॉल्डवल,	काल्डवेल,	
shakir,	शकीर,	शाकिर,	
kalapi,	कलापि,	कालपी,	
england,	इंग्लैंड,	इंग्लैंड,	
simtataa,	सिमतता,	सिमटता,	
songs,	सांग्स,	सॉन्ग्स,	
antaha,	अंताहा,	अंतः,	
vahikayen,	वाहिकाएं,	वाहिकाएं,	
toh,	तोह,	तो,	
bhareeye,	भारीए,	भारीय,	
baksa,	बक्स,	बक्सा,	
kazi,	काजी,	काजी,	
propellant,	प्रोपललेंट,	प्रोपेलेंट,	
vidyaen,	विद्याएं,	विद्याएं,	
scootaron,	स्कूटरों,	स्कूटरों,	
sanchalnon,	संचालनों,	संचालनों,	
napa,	नापा,	नापा,	
mardaani,	मरदानी,	मरदानी,	
daak,	दाक,	डाक,	
chauda,	चौड़ा,	चौड़ा,	
around,	अराउंड,	अराउंड,	
gujarata,	गुजराता,	गुजारता,	
lasoon,	लासुन,	लहसुन,	
niveshkarta,	निवेशकर्ता,	निवेशकर्ता,	
alankaaron,	अलंकारों,	अलंकारों,	
hani,	हानी,	हानी,	
raaji,	राज़ी,	राजी,	
satpal,	सत्पल,	सतपाल,	
padhaataa,	पढ़ता,	पढ़ाता,	
ligar,	लीगार,	लिगर,	
kapdo,	कप्दों,	कपड़ो,	
kpo,	कपपो,	केपीओ,	
prabodhini,	प्रबोधिनी,	प्रबोधिनी,	
beejak,	बीजक,	बीजक,	
sinabang,	सिनाबंग,	सिनाबंग,	
bimon,	बीमोन,	बीमों,	
ruganta,	रुगांता,	रुग्णता,	
bhagane,	भागने,	भगाने,	
canterbari,	कैंटरबारी,	कैंटरबरी,	
dipsingh,	डिपिंंह,	दीपसिंह,	
nikaalni,	निकालनी,	निकालनी,	
melani,	मेलनी,	मेलानी,	
imaging,	इमाजिंग,	इमेजिंग,	
mithaai,	मिथाई,	मिठाई,	
dhundhata,	ढुंढाता,	ढूंढता,	
uthaapatak,	उठापत्,	उठापटक,	
bhookh,	भुख,	भूख,	
hemwati,	हेमवती,	हेमवती,	
bhavanaon,	भवानाओं,	भावनाओं,	
uplaksh,	उपलकक्ष,	उपलक्ष्य,	
thengaa,	ठेंगा,	ठेंगा,	
han,	हान,	हां,	
vishahin,	विशाहीन,	विषहीन,	
dhoraaji,	धोराजी,	धोराजी,	
jinee,	जिनी,	जिनी,	
anyay,	अन्याय,	अन्याय,	
usmen,	उसमें,	उसमें,	
nasim,	नसीम,	नसीम,	
emerald,	एमरेड्ड,	एमरल्ड,	
sanskritiyan,	संस्कृतियां,	संस्कृतियां,	
mahavigyan,	महाविज्ञान,	महाविज्ञान,	
besahara,	बेसहरा,	बेसहारा,	
font,	फॉन्ट,	फॉन्ट,	
rahenge,	रहेंगे,	रहेंगे,	
chhallaa,	छल्ला,	छल्ला,	
prapaat,	प्रपाट,	प्रपात,	
pic,	पीआईसी,	पिक,	
raatrichar,	रात्िचार,	रात्रिचर,	
pahni,	पहनी,	पहनी,	
vividh,	विविध,	विविध,	
kriyayog,	क्रियायोग,	क्रियायोग,	
shringar,	श्रृंगार,	शृंगार,	
dhankuber,	धंजुबोर,	धनकुबेर,	
prathamik,	प्राठममिक,	प्राथमिक,	
clay,	क्ले,	क्ले,	
mehkane,	महकाने,	महकने,	
stan,	स्टान,	स्टैन,	
raktabh,	रक्तभ,	रक्ताभ,	
singhaadey,	सिंहाड़े,	सिंघाड़े,	
adhyayanarat,	अध्ययनारत,	अध्ययनरत,	
munafa,	मुनाफा,	मुनाफा,	
dhundh,	धुंध,	ढूंढ,	
niptaaraa,	निपटारा,	निपटारा,	
pushp,	पुश्प,	पुष्प,	
chhutane,	छुटनेे,	छूटने,	
dhiryavan,	धिर्यवान,	धैर्यवान,	
mason,	मसों,	मासों,	
january,	ज़न्रे,	जनवरी,	
murmur,	मूरमूर,	मरमर,	
chhuraa,	छुड़ा,	छुरा,	
pammu,	पम्मू,	पम्मी,	
maisor,	मैसरर,	मैसोर,	
jajamau,	जज़ाऊ,	जाजमऊ,	
sanyojan,	संयोजन,	संयोजन,	
macbook,	माबूक,	मैकबुक,	
braat,	ब्राट,	बरात,	
amit,	अमिट,	अमित,	
krantiyon,	क्रांतियों,	क्रांतियों,	
jeen,	जीन,	जीन,	
mejban,	मेबन,	मेजबान,	
kolorado,	कोलोरोडो,	कोलोराडो,	
amadan,	अमदन,	आमदन,	
barsa,	बरसा,	बरसा,	
bazi,	बाजी,	बाज़ी,	
jaden,	जाड़ें,	जड़ें,	
rishikul,	रिशिकुल,	ऋषिकुल,	
batalvi,	बतलावी,	बटालवी,	
ramraj,	रामराज,	रामराज,	
dadari,	दादरी,	दादरी,	
domenic,	डोमेनिक,	डोमेनिक,	
pakaayen,	पकाएं,	पकाएं,	
darmiyan,	दरममियां,	दरमियान,	
namkin,	नम्किन,	नमकीन,	
besin,	बेसिन,	बेसिन,	
mahasingh,	महासिंह,	महासिंह,	
taul,	ताल,	तौल,	
chuka,	चुका,	चौका,	
thaanvi,	ठानवी,	थानवी,	
diaries,	डायरीज,	डायरीज,	
emailon,	इमैइलों,	ईमेलों,	
prahad,	प्रदाड़,	प्रह्लाद,	
pythogaras,	पैथोगारास,	पाइथागोरस,	
harjeet,	हरजीत,	हारजीत,	
likhkar,	लिख्कर,	लिखकर,	
ounce,	आंस,	आउंस,	
shin,	शीन,	क्षीण,	
fortis,	फोर्टिस,	फोर्टिस,	
spry,	स्प्री,	स्प्रे,	
bhraantiyan,	भ्रांतियां,	भ्रांतियां,	
dhammaa,	धम्मा,	धम्मा,	
farukhnagar,	फरुख्ागर,	फर्रूखनगर,	
baahulya,	बाहुल्य,	बाहुल्य,	
godara,	गोदारा,	गोदारा,	
bechkar,	बेचकर,	बेचकर,	
ganthe,	गंथे,	गांठे,	
humlavar,	हुललावर,	हमलावर,	
yari,	यारी,	यारी,	
ladai,	लड़ाई,	लड़ाई,	
pinta,	पिंटा,	पिंटा,	
samshayon,	समशायों,	संशयों,	
aavritiyon,	आवृतियों,	आवृत्तियों,	
stops,	स्टॉप्स,	स्टॉप्स,	
shabdarth,	शब्दार्थ,	शब्दार्थ,	
zalzale,	जलजलाले,	ज़लज़ले,	
geneva,	जेनेवा,	जिनीवा,	
uttara,	उत्तरा,	उत्तरा,	
anhoni,	अनोहीन,	अनहोनी,	
rehana,	रहना,	रेहाना,	
hoshangabad,	होषनाब़्ाड़,	होशंगाबाद,	
vedon,	वेडों,	वेदों,	
dungarpur,	दूगरपुर,	डूंगरपुर,	
budvig,	बुड्वगग,	बुडविग,	
vinit,	विनित,	विनीत,	
mehram,	मेहमा,	मेहराम,	
brahmleen,	ब्रह्मली,	ब्रह्मलीन,	
kping,	क्पिंग,	कपिंग,	
barahmasi,	बारहाससी,	बारहमासी,	
snickers,	स्निकर्स,	स्नीकर्स,	
weeks,	विक्स,	वीक्स,	
bhadkaya,	भड़काया,	भड़काया,	
wealth,	विल्थ,	वेल्थ,	
varsaryache,	वर्सर्चेच,	वर्साचे,	
earth,	ईर्थ,	अर्थ,	
girati,	गिराी,	गिरती,	
kaushambi,	कौशंबी,	कौशाम्बी,	
haive,	हैइव,	हैव,	
samadhiyon,	समाधियों,	समाधियों,	
trangistor,	ट्रांजिस्टर,	ट्रांजिस्टर,	
jeevniyaan,	जीवनियां,	जीवनियां,	
vadiyon,	वादियों,	वादियों,	
baadhit,	बाधित,	बाधित,	
ralod,	रालोड,	रालोद,	
taantaa,	टांटा,	तांता,	
napane,	नापने,	नापने,	
tired,	टायरड,	टायर्ड,	
sinha,	सिन्हा,	सिंहा,	
mauma,	मौमम,	मौमा,	
shujat,	शुजात,	शुजात,	
vyabhichar,	व्याभिचार,	व्यभिचार,	
vikramjeet,	विक्रमजित,	विक्रमजीत,	
weldor,	वेलडरर,	वेल्डर,	
haani,	हानी,	हानी,	
augustine,	आगस्टीनी,	अगस्टाइन,	
vasharan,	वााषण,	वर्शन,	
dune,	दूने,	दूने,	
jataati,	जताती,	जताती,	
mezabani,	मेजबबनी,	मेजबानी,	
cil,	सील,	सीआईएल,	
poojapath,	पूजापथ,	पूजापाठ,	
seti,	सेती,	सेटी,	
jeepney,	जीपने,	जीपनी,	
aavishkaar,	आविष्कार,	आविष्कार,	
girkar,	गिरकार,	गिरकर,	
sohawal,	सोहवाल,	सोहावल,	
tharti,	थरतती,	थर्टी,	
prashaasanik,	प्रशासनिक,	प्रशासनिक,	
barrackpore,	बर्कौकपर,	बैरकपुर,	
badhotri,	बढोोत्रि,	बढ़ोतरी,	
nihlaani,	निहहानी,	निहलानी,	
jununi,	जुनूनी,	जुनूनी,	
dork,	डोर्क,	डॉर्क,	
dukanon,	दुकानों,	दुकानों,	
granthiyan,	ग्रांथियां,	ग्रंथियां,	
najraane,	नज़ााने,	नजराने,	
budwig,	बुडववगग,	बुडविग,	
sevakon,	सेवकों,	सेवकों,	
perafin,	पैराफिन,	पैराफिन,	
vadli,	वद्ी,	वडाली,	
hijada,	हिजड़ा,	हिजड़ा,	
prapta,	प्रप्त,	प्राप्त,	
arya,	आर्य,	आर्यो,	
bostan,	बोस्टान,	बॉस्टन,	
bastiyon,	बस्तियों,	बस्तियों,	
abbot,	अबबोत,	एबोट,	
dhande,	धंडे,	धंधे,	
fus,	फस,	फूस,	
patrani,	पत्रणी,	पटरानी,	
aise,	एसे,	ऐसे,	
aagman,	आगमन,	आगमन,	
tankar,	टैंकर,	टंकार,	
langda,	लंंगड़ा,	लंगड़ा,	
thanjavur,	तंजावूर,	तंजावुर,	
dampattiyon,	दामपत्तियों,	दंपतियों,	
isaiyon,	ईसाईयों,	ईसाइयों,	
panama,	पन्म,	पनामा,	
yojanaen,	योजनाएं,	योजनाएं,	
parwaa,	परवा,	परवा,	
sanskaar,	संस्कार,	संस्कार,	
nazraane,	नज़राने,	नजराने,	
mejbaan,	मेजबान,	मेजबान,	
falta,	फालता,	फलता,	
dabhara,	दभारा,	डभरा,	
jasmeet,	जसमीत,	जसमीत,	
programmers,	प्रोग्रामर्स,	प्रोग्रामर्स,	
anukoltha,	अनुकोलता,	अनुकूलता,	
bhairavnath,	भैरावनाथ,	भैरवनाथ,	
bhugat,	भुगत,	भुगत,	
rambharosey,	रामभरोसी,	रामभरोसे,	
fund,	फूंद,	फंड,	
francisco,	फ्रैंसिस्को,	फ्रांसिस्को,	
bapaa,	बापा,	बापा,	
panchaang,	पंचांग,	पंचांग,	
samanwayaka,	समन्वयका,	समन्वयक,	
jing,	जिंग,	जिंग,	
vastavik,	वास्तविक,	वास्तविक,	
tuberkyulosis,	टुब्रकक्यूलिस,	ट्यूबरक्यूलोसिस,	
dahal,	दहाल,	दहल,	
eater,	ईटर,	ईटर,	
lagnevaaley,	लगननेवाले,	लगनेवाले,	
nega,	नेगा,	नेग,	
lagnewale,	लगनेवाले,	लगनेवाले,	
chamakna,	चमक्न,	चमकना,	
aawajen,	आवाजें,	आवाज़ें,	
chehon,	चीहों,	छहों,	
refaeli,	रिफेली,	रेफेली,	
ayodhyeanath,	अयोध्यानाथ,	अयोध्यानाथ,	
avika,	अविका,	अविका,	
bhulata,	भुलता,	भूलता,	
khajraana,	खजराना,	खजराना,	
eddie,	एडीड,	एड्डी,	
mode,	मोड़,	मॉड,	
udaanon,	उड़नों,	उड़ानों,	
bholi,	भोली,	भोली,	
wadiyon,	वाडियों,	वादियों,	
stre,	स्ट्रे,	स्ट्रे,	
sachhidanand,	सचीदानंद,	सच्चिदानंद,	
chart,	चर्ट,	चार्ट,	
dridh,	द्रीध,	दृढ़,	
deshkal,	देशकाल,	देशकाल,	
traip,	ट्रैप,	ट्रैप,	
bhate,	भाटे,	भाते,	
raagon,	रागों,	रागों,	
putali,	पुटली,	पुतली,	
tikon,	टीकों,	टीकों,	
laingikta,	लैंगीकता,	लैंगिकता,	
shrankhalaa,	श्रृंखला,	श्रंखला,	
gaumukh,	गौमुख,	गौमुख,	
olavrishti,	ओलावृष्टि,	ओलावृष्टि,	
heeraganj,	हीरागंज,	हीरागंज,	
sipahi,	सिपाही,	सिपाही,	
purvaabhas,	पूर्वाभास,	पूर्वाभास,	
vyvhargat,	व्यवहररत,	व्यवहारगत,	
dhandon,	ढंडों,	धंधों,	
funding,	फुंडिंग,	फंडिंग,	
mahavishnu,	महाविष्णु,	महाविष्णु,	
tanish,	तननीश,	टैनिस,	
jenny,	जेनी,	जेनी,	
vidhivat,	विधिवत,	विधिवत,	
charas,	चारस,	चरस,	
jivant,	जीवंत,	जीवंत,	
lebalon,	लेबलों,	लेबलों,	
machaye,	मचाये,	मचाए,	
haan,	हान,	हां,	
gangaajal,	गंगाजल,	गंगाजल,	
kruger,	क्रूजर,	क्रूगर,	
thki,	थकी,	थकी,	
welder,	वेल्डर,	वेल्डर,	
francisca,	फ्रैंसिस्का,	फ्रांसिस्का,	
khilana,	खिलना,	खिलाना,	
putul,	पुतुल,	पुतुल,	
pushkarnaa,	पुष्करण,	पुष्करणा,	
hilane,	हिलने,	हिलने,	
lenevali,	लेनेवाली,	लेनेवाली,	
vayana,	वायना,	वायना,	
phoos,	फूज,	फूस,	
khaastaur,	खासतौर,	ख़ासतौर,	
canterbury,	कैंटरबररी,	कैंटरबरी,	
welwet,	वेलवेट,	वेलवेट,	
sprint,	स्प्रिंट,	स्प्रिट,	
pokar,	पोकर,	पोकर,	
shanivar,	शानीवार,	शनिवार,	
nichla,	निचला,	निचला,	
sanyojanon,	संयोजनों,	संयोजनों,	
farrukhnagar,	फररुखनागर,	फर्रूखनगर,	
bounceron,	बाउंसरों,	बाउंसरों,	
nikaalani,	निकालनी,	निकालनी,	
cube,	क्यूब,	क्यूब,	
dukke,	डक्के,	दुक्के,	
thirake,	थिरके,	थिरके,	
lakme,	लक्ेम,	लक्मे,	
khaini,	खैनी,	खैनी,	
wajood,	वजजद,	वजूद,	
badha,	बढ़ा,	बाधा,	
dukaanon,	दुकानों,	दुकानों,	
raajon,	राजों,	राजों,	
bk,	बीके,	बीके,	
lajjalu,	लजजला,	लज्जालु,	
yatnaon,	यतनाओं,	यातनाओं,	
jaankaron,	जानकरों,	जानकारों,	
kanthahar,	कंठहहार,	कंठहार,	
niketan,	निकेतन,	निकेतन,	
jaanch,	जांच,	जाँच,	
harpal,	हरपाल,	हरपाल,	
chowk,	चौक,	चौक,	
dwaadas,	द्वासा,	द्वादश,	
jerry,	जेरी,	जैरी,	
sooja,	सूजा,	सूजा,	
baago,	बागो,	बागो,	
subhay,	सभभा,	सुभाय,	
westinghouse,	वेस्इंहास,	वेस्टिंगहाउस,	
cubes,	क्ब्स,	क्यूब्स,	
hijbul,	हिजबुल,	हिजबुल,	
nations,	नेट्संस,	नेशंस,	
trott,	ट्रोट्ट,	ट्रॉट,	
paranormal,	परणोोर्मल,	पैरानॉर्मल,	
vishwasniiya,	विश्वस्ीय,	विश्वसनीय,	
ia,	आए,	ईए,	
qasim,	कासिम,	कासिम,	
anureet,	अनुरीत,	अनुरीत,	
peelepan,	पीलेपन,	पीलेपन,	
faaf,	फाफ,	फाफ,	
pitne,	पिटने,	पीटने,	
yatraein,	यात्राएं,	यात्राएं,	
uthane,	उठाने,	उठने,	
vibhram,	विभ्रम,	विभ्रम,	
dhakkal,	ढक्कल,	ढकाल,	
gujarate,	गुजराते,	गुजारते,	
guman,	गुमान,	गुमान,	
talawe,	तलावे,	तलवे,	
lovasa,	लोवासा,	लवासा,	
swecha,	स्वेच्छा,	स्वेच्छा,	
roni,	रोनी,	रोनी,	
inhalation,	इन्हालेयन,	इनहेलेशन,	
shahrvasiyon,	शहरवासियों,	शहरवासियों,	
pipli,	पीपली,	पिपली,	
prakkathan,	प्रक्थान,	प्राक्कथन,	
singar,	सिंगर,	सिंगार,	
polishing,	पॉलिशिंग,	पॉलिशिंग,	
akapulko,	अकापललको,	अकापुल्को,	
vareinye,	वारेनी,	वरेण्य,	
jiniva,	जिनीवा,	जिनीवा,	
beef,	बीफ,	बीफ,	
aisa,	एसा,	एेसा,	
dreijer,	ड्रेजर,	ड्रेजर,	
nicki,	निकी,	निकी,	
upakhyaanon,	उपाख्यानों,	उपाख्यानों,	
poshit,	पोशित,	पोषित,	
chitthi,	चित्ती,	चिट्ठी,	
lahraee,	लहराई,	लहराई,	
rasaayanon,	रसायंों,	रसायनों,	
udhrva,	उध्रवा,	ऊर्ध्व,	
katasaraj,	कटसरराज,	कटासराज,	
parwa,	परवा,	परवा,	
laganewale,	लगनेवाले,	लगनेवाले,	
shooting,	शूटिंग,	शुटिंग,	
yaari,	यारि,	यारी,	
sabhasadon,	सभासादों,	सभासदों,	
water,	वाटर,	वाटर,	
chabutare,	चबूतारे,	चबूतरे,	
azhar,	आज़र,	अजहर,	
routes,	रोटट्स,	रूट्स,	
multai,	मुलताई,	मुल्ताई,	
khani,	खानी,	खनि,	
karpatri,	कर्पततररी,	करपात्री,	
tapan,	तपान,	तपन,	
munshiganj,	मुंशीगंज,	मुंशीगंज,	
kankad,	कंकड़,	कंकड़,	
aake,	आके,	आके,	
aagaashe,	आगाशे,	आगाशे,	
ruby,	रूबी,	रुबी,	
leaderon,	लीडरों,	लीडरों,	
madhura,	मधुरा,	मढ़ौरा,	
aakhet,	आखेत,	आखेट,	
dhokebaj,	धोखेबाज,	धोखेबाज,	
maharaja,	महाराजा,	महाराजा,	
anuprayogi,	अनुप्राोगी,	अनुप्रयोगों,	
khoya,	खोया,	खोया,	
rupak,	रुपक,	रूपक,	
nidhaan,	निधान,	निधान,	
juban,	जुबान,	ज़ुबान,	
putliyan,	पुटलियां,	पुतलियां,	
dhari,	धारी,	धारी,	
aapadaaaen,	आपदाएं,	आपदाएं,	
khanikarm,	खनिकर्म,	खनिकर्म,	
jalvayu,	जलवायु,	जलवायु,	
sund,	सूंड,	सूंड़,	
kapda,	कपड़ा,	कपड़ा,	
fatehgadh,	फटेहाढ़,	फतेहगढ़,	
save,	सेव,	सेव,	
uplabdh,	उपलबब्ध,	उपलब्ध,	
ghongha,	घोंघा,	घोंघा,	
alps,	अल्प्स,	ऐल्प्स,	
mangi,	मंगी,	मांगी,	
mahapauron,	महापोरों,	महापौरों,	
aadhunik,	आधुनिक,	आधुनिक,	
achivement,	अकिवमेेंट,	अचीवमेंट,	
utpan,	उत्पान,	उत्पन,	
maarvaad,	मार्वाद,	मारवाड़,	
dabhra,	दभरा,	डभरा,	
arbab,	अरबब,	अरबाब,	
paltane,	पलटाने,	पलटने,	
module,	मोडुले,	मॉड्यूल,	
tansen,	टंसें,	तानसेन,	
trubyunal,	ट्रुब्यून,	ट्रिब्यूनल,	
yaariyan,	यारियां,	यारियां,	
parlouron,	पार्लोों,	पार्लरों,	
chhabi,	छाबी,	छबि,	
parishad,	परिषद,	परिषद,	
dikhai,	दिखाई,	दिखाईं,	
generate,	जनरेट,	जेनरेट,	
ata,	अता,	आटा,	
achambha,	अचंभा,	अचंभा,	
mejbani,	मेबबनी,	मेजबानी,	
dhaga,	ढागा,	धागा,	
deeya,	दीया,	दीया,	
katthai,	कट्ठाई,	कत्थई,	
claris,	क्लारिस,	क्लेरिस,	
bhukh,	भुख,	भूख,	
angkor,	अंगकोर,	अंकोर,	
takravon,	टकरावों,	टकरावों,	
suljayi,	सुलझाई,	सुलझाई,	
birth,	बीर्थ,	बर्थ,	
lingbhed,	लिंग्हेड,	लिंगभेद,	
vaimanasya,	वैमानस्य,	वैमनस्य,	
advaitvaad,	अदवैततावाद,	अद्वैतवाद,	
peranormal,	पैरानोर्मल,	पैरानॉर्मल,	
puranpur,	पुरापपुर,	पूरनपुर,	
nanak,	नानक,	नानक,	
gatishilata,	गतिशीलता,	गतिशीलता,	
modern,	मॉडररन,	मॉडर्न,	
jadit,	जादित,	जड़ित,	
peratrupers,	पैरार्टरपर्स,	पैराट्रूपर,	
shaniwar,	शानीवार,	शनिवार,	
sarjuga,	सरजूगा,	सरगुजा,	
cigretton,	सिग्रेटन,	सिगरेटों,	
earthquake,	आर्थक्यूक,	अर्थक्वेक,	
ropane,	रोपने,	रोपने,	
teap,	टीप,	टिप,	
wadali,	वादली,	वडाली,	
sahdev,	सहदेव,	सहदेव,	
vaadak,	वादक,	वादक,	
jalvaayu,	जलवायु,	जलवायु,	
moshe,	मोशे,	मोशे,	
aadharit,	आधारित,	आधारित,	
broken,	ब्रॉकेन,	ब्रोकन,	
tied,	टीड,	टायर्ड,	
order,	ऑर्डर,	आर्डर,	
dadreva,	ददरेवा,	ददरेवा,	
navjaagaran,	नवजागरण,	नवजागरण,	
fefada,	फेफादा,	फेफड़ा,	
rahamat,	रहमात,	रहमत,	
divya,	दिव्य,	दिव्या,	
takara,	टकरा,	टकरा,	
maukon,	मौकों,	मौकों,	
rasayanik,	रसस्यिक,	रासायनिक,	
dhoondhi,	धूंधी,	ढूंढी,	
babt,	बब्त,	बाबत,	
pajej,	पाजेज,	पेजेज,	
muflisi,	मुफलिसी,	मुफलिसी,	
eyer,	आयर,	इअर,	
ilaaj,	इलाज,	इलाज,	
purane,	पूराने,	पुराने,	
janam,	जन्म,	जानम,	
niveshakartaa,	निवेशाकरत,	निवेशकर्ता,	
chiththi,	चित्थी,	चिठ्ठी,	
ramkot,	रामकोट,	रामकोट,	
hostess,	होस्टेस,	होस्टेस,	
hippopotamus,	हिप्पोटापोम्स,	हिप्पोपोटेमस,	
catholicon,	कैथलिकों,	कैथोलिकों,	
suraj,	सुरज,	सूरज,	
pr,	पीआर,	पीआर,	
grist,	ग्रिस्ट,	ग्रीस्ट,	
peaking,	पीकिंग,	पीकिंग,	
banthiya,	बांथिया,	बांठिया,	
anupryogon,	अनुप्रोोगों,	अनुप्रयोगों,	
singhre,	सिंहरर,	सिंघाड़े,	
advaitwad,	अदववैताद,	अद्वैतवाद,	
shavkon,	शावकों,	शावकों,	
kide,	कीड़,	कीड़े,	
chitrkar,	चित्रकार,	चित्रकार,	
inhaletion,	इनहालिशन,	इनहेलेशन,	
submission,	सब्िशन,	सबमिशन,	
sevkon,	सेवकों,	सेवकों,	
eyarave,	एयरवे,	एयरवे,	
durgun,	दुर्गुण,	दुर्गुण,	
ripon,	रिपों,	रिपन,	
praharak,	प्रारकक,	प्रहारक,	
asaamnjsy,	असामंं्,	असामंजस्य,	
suneeti,	सुनीती,	सुनीति,	
pahnakar,	पहनकर,	पहनाकर,	
ardaas,	अर्दास,	अरदास,	
lbada,	लबड़ा,	लबादा,	
dhakaal,	ढकाल,	ढकाल,	
kabron,	काररों,	कब्रों,	
tanjavur,	तंजावूर,	तंजावुर,	
shaakir,	शाकीर,	शाकिर,	
alance,	अलंस्,	अलायंस,	
gaumutr,	गौमुत्र,	गौमूत्र,	
creg,	क्रेग,	क्रेग,	
sahadev,	सहादेव,	सहदेव,	
prayasarat,	प्रयासरत,	प्रयासरत,	
sthulata,	स्थुलता,	स्थूलता,	
dhakelte,	ढकेलते,	धकेलते,	
tarfa,	तर्फा,	तरफा,	
byavar,	ब्यावर,	ब्यावर,	
official,	ऑफिशियल,	ऑफिशियल,	
ghisai,	घिसाई,	घिसाई,	
jeera,	जीरा,	जीरा,	
jenni,	जेनी,	जेनी,	
hounga,	हाउंगा,	होऊंगा,	
jaawar,	जावर,	जावर,	
ethhan,	ऐंठन,	ऐठन,	
antoni,	एंटोनी,	एंटोनी,	
jalbhrav,	जलभ्रव,	जलभराव,	
pushpit,	पुष्पित,	पुष्पित,	
bhola,	भोला,	भोला,	
gumaan,	गुमान,	गुमान,	
girijaghar,	गिरिजाघर,	गिरजाघर,	
daratey,	डरते,	डराते,	
hawalat,	हवालत,	हवालात,	
jaylalita,	जयललिता,	जयललिता,	
marathi,	मररथी,	मराठी,	
tahi,	तही,	ताहि,	
tanta,	टांटा,	तांता,	
grandson,	ग्रांड्सन,	ग्रैंडसन,	
federal,	फेडरल,	फैडरल,	
malish,	मलीश,	मालिश,	
saptapadi,	सप्ताददी,	सप्तपदी,	
supachya,	सुपा्य,	सुपाच्य,	
insurance,	इनस्रूंस,	इंश्योरेंस,	
juti,	जुती,	जुटी,	
aahnaan,	आहनान,	आह्नान,	
manzil,	मंजिल,	मंजिल,	
stop,	स्टॉप,	स्टॉप,	
anaavashyak,	अनावश्यक,	अनावश्यक,	
tel,	टेल,	तेल,	
failaiye,	फैलाईए,	फैलाइए,	
jayalalithaa,	जयलालि,	जयललिता,	
pihaani,	पिहानी,	पिहानी,	
padega,	पडेगा,	पड़ेगा,	
ilaj,	इलाज,	इलाज,	
dhanadhany,	धननढन्य,	धनधान्य,	
batlaae,	बतलाई,	बतलाए,	
jamati,	जमतती,	जमाती,	
trijata,	त्रिजता,	त्रिजटा,	
audyogikarana,	औद्योगिकरण,	औद्योगिकरण,	
laurense,	लारेंस,	लौरेंस,	
suryadev,	सूर्यदेव,	सूर्यदेव,	
kushaan,	कुशान,	कुषाण,	
danptiyon,	दांपतियों,	दंपतियों,	
anchahe,	अंचहे,	अनचाहे,	
chrome,	क्रोम,	क्रोम,	
skala,	स्काल,	स्काला,	
andhapan,	अंधपान,	अंधापन,	
rangate,	रंगते,	रंगते,	
alnkaron,	अलंकरों,	अलंकारों,	
aaryan,	आर्यन,	आर्यों,	
baljit,	बालजीत,	बलजीत,	
spelar,	स्पीलर,	स्पेलर,	
pakaude,	पकौड़े,	पकौड़े,	
ijajat,	इजाज़त,	इजाजत,	
dharak,	धरक,	धारक,	
sat,	साट,	सत,	
thaili,	थैली,	थैली,	
eyarve,	एयरव,	एयरवे,	
amaanat,	अमानत,	अमानत,	
theateron,	थियटरों,	थिएटरों,	
nilabh,	नीलाभ,	नीलाभ,	
kushan,	कुशा,	कुषाण,	
aastin,	आस्तिन,	आस्तीन,	
chi,	ची,	ची,	
ria,	रिआ,	रिया,	
mithila,	मिथिला,	मिथिला,	
jalagati,	जलागती,	जलगति,	
lti,	एलटीआई,	एलटीई,	
sim,	सिम,	सिम,	
raubdar,	रौबदार,	रौबदार,	
devnaar,	देवनार,	देवनार,	
ustara,	उस्तारा,	उस्तरा,	
shetron,	क्षेत्रों,	क्षेत्रों,	
duneerti,	दुनीर्ती,	दुर्नीति,	
adhyayanrat,	अध्ययन्रत,	अध्ययनरत,	
rajtantra,	राजतंत्र,	राजतंत्र,	
eesa,	ईजा,	एेसा,	
najibabaad,	नजीबबबाद,	नजीबाबाद,	
daw,	डॉ,	दाव,	
noon,	नून,	नून,	
samjhunga,	समझौंग,	समझूंगा,	
pushkin,	पुष्किन,	पुश्किन,	
allergic,	अलेर्टिक,	एलर्जिक,	
sujhaati,	सुझाती,	सुझाती,	
hooper,	हुपर,	हूपर,	
naino,	नैनो,	नैनो,	
labelo,	लेबलो,	लेबलों,	
udanon,	उड़नों,	उड़ानों,	
gr,	गीआर,	जीआर,	
anudit,	अनुदित,	अनूदित,	
kaping,	केपिंग,	कपिंग,	
alive,	एलावव,	अलाइव,	
aajmana,	आजमान,	आजमाना,	
vaigyanikta,	वैग्ञानिकता,	वैज्ञानिकता,	
bhisham,	भिषम,	भीष्म,	
clerys,	क्लेर्स,	क्लेरिस,	
jasmit,	जसमित,	जसमीत,	
rowan,	रोवन,	रोवन,	
da,	दा,	दा,	
dastana,	दस्तान,	दस्ताना,	
sealed,	सील्ड,	सील्ड,	
tension,	टेन्शन,	टेंशन,	
met,	मैट,	मेट,	
judaai,	जुदाई,	जुड़ाई,	
gujar,	गुजर,	गुजार,	
sahakalakar,	सहकालकार,	सहकलाकार,	
fransiska,	फ्रांसिस्का,	फ्रांसिस्का,	
strocks,	स्ट्रॉक्स,	स्ट्रोक्स,	
chausinga,	चौसिंगा,	चौसिंगा,	
bhavnaon,	भावनाओं,	भावनाओं,	
suba,	सुबा,	सूबा,	
katrina,	कत्रीन,	कैटरीना,	
sujen,	सूजें,	सुजेन,	
fawaaron,	फवारों,	फव्वारों,	
ravish,	रवीष,	रविश,	
sfoorti,	स्फूर्ती,	स्फूर्ति,	
chiththi,	चित्थी,	चिट्ठी,	
rudolf,	रूडल्फ,	रुडोल्फ,	
pujapath,	पूजापठ,	पूजापाठ,	
baini,	बैनी,	बैनी,	
farookhabad,	फरुखबाड़,	फर्रुखाबाद,	
daav,	दाव,	दाव,	
bethnal,	बेथनाल,	बेथनल,	
jockey,	जॉकी,	जोकि,	
namkeen,	नमकीन,	नमकीन,	
siyaha,	सियाहा,	सियाह,	
paratrooper,	पारतूरूप,	पैराट्रूपर,	
patki,	पट्ी,	पटकी,	
vangchuk,	वांचचुक,	वांगचुक,	
badata,	बद़ता,	बढ़ाता,	
fatama,	फतमा,	फातमा,	
sambit,	संबित,	संबित,	
bells,	बेल्स,	बैल्स,	
batlaakar,	बतलाकर,	बतलाकर,	
naraji,	नाराजी,	नाराजी,	
vibha,	विभा,	विभा,	
marji,	मर्जी,	मर्जी,	
sarahi,	सारही,	सराही,	
rugna,	रूग्ण,	रुग्ण,	
singhi,	सिंही,	सिंघी,	
haldi,	हल्दी,	हल्दी,	
agha,	आघा,	आग़ा,	
aajmaanaa,	आजमाना,	आजमाना,	
bakse,	बक्से,	बक्से,	
damale,	दमले,	दामले,	
dhyeywadi,	ध्ययवादी,	ध्येयवादी,	
sapaat,	सपात,	सपाट,	
lakshya,	लक्ष्य,	लक्ष्य,	
swiftlate,	स्विफ्टलेट,	स्विफ्टलेट,	
gthalidar,	गथालीदार,	गुठलीदार,	
reeta,	रीता,	रीता,	
chhaviyan,	छावियां,	छवियाँ,	
sanskaari,	संस्कारी,	संस्कारी,	
rajneetikaran,	राजनीतीकरण,	राजनीतीकरण,	
halla,	हल्ला,	हल्ला,	
naukri,	नौकरी,	नोकरी,	
prathmiki,	प्राथमिकि,	प्राथमिकी,	
swechha,	स्वेच्छ,	स्वेच्छा,	
biggest,	बिग्सेस्ट,	बिगेस्ट,	
jipani,	जिपानी,	जीपनी,	
sahkalakar,	सहकालकार,	सहकलाकार,	
packard,	पैक्डर,	पैकर्ड,	
naakaam,	नाकाम,	नाकाम,	
rehaana,	रहहाना,	रेहाना,	
heros,	हीरोस,	हीरोज,	
aavrittiyon,	आवृत्तियों,	आवृत्तियों,	
lemon,	लेमोन,	लेमन,	
yugm,	यज्म,	युग्म,	
tagde,	तग्ेे,	तगड़े,	
apariharya,	अपरिहार्य,	अपरिहार्य,	
vesle,	वेसले,	वेस्ले,	
kankad,	कंकड़,	कंकर,	
maisachusets,	मैसाचोस्स,	मैसाचुसेट्स,	
visheshaadhikaar,	विशेषाधिकार,	विशेषाधिकार,	
avaru,	अवरू,	अवरु,	
dinaank,	दिनांक,	दिनांक,	
billaa,	बिल्ला,	बिल्ला,	
mum,	मूम,	मम,	
spell,	स्पेल,	स्पेल,	
paraadhin,	पराधीन,	पराधीन,	
hadauti,	हडौती,	हाड़ौती,	
anawashyak,	अनावश्यक,	अनावश्यक,	
ubuntu,	उबुंतू,	उबंटू,	
samalakhaa,	समलखा,	समालखा,	
pahno,	पहनों,	पहनो,	
ghumakkadi,	घुमक्कडी,	घुमक्कड़ी,	
khuda,	खुडा,	खुदा,	
rita,	रीता,	रीता,	
chhupta,	छुप्ता,	छुपता,	
brijesh,	ब्रजेश,	ब्रजेश,	
shao,	शाओ,	शाओ,	
kamottejana,	कामट्टेजन,	कामोत्तेजना,	
arya,	आर्य,	आर्य,	
ronit,	रोनिट,	रोनित,	
sitaharan,	सीताहरण,	सीताहरण,	
asurakshit,	असुरक्षित,	असुरक्षित,	
moodi,	मूडी,	मूडी,	
sanasthita,	संस्थिति,	संस्थिता,	
ijaajat,	इजाज़त,	इजाजत,	
barahamasi,	बारहामसी,	बारहमासी,	
herald,	हेराल्ड,	हैराल्ड,	
falata,	फलता,	फलता,	
lives,	लिवेस,	लाइव्स,	
canals,	केनल्स,	कनाल,	
mexico,	मैक्सिको,	मेक्सिको,	
bharne,	भरने,	भरने,	
asharaphi,	अशाराही,	अशरफी,	
mejbaani,	मेजबानी,	मेजबानी,	
baku,	बाकू,	बाकू,	
laingadan,	लैंगान,	लैंगडन,	
bhoopsingh,	भूपसिंह,	भूपसिंह,	
pehnati,	पहनती,	पहनाती,	
forcee,	फोर्सी,	फारसी,	
vaisaakh,	वैसाख,	वैशाख,	
ghumakkaron,	घुमक्करों,	घुमक्कड़ों,	
chor,	चोर,	चोर,	
devi,	देवी,	डेवी,	
pigs,	पिग्स,	पिग्स,	
test,	टेस्ट,	टेस्ट,	
chabutre,	चबूत्रे,	चबूतरे,	
char,	चार,	चार,	
dhuni,	धुनी,	धूनी,	
munaf,	मुनाफ,	मुनाफ,	
badali,	बदली,	बदली,	
sudhargruh,	सुधारगारूह,	सुधारगृह,	
karta,	करता,	कटरा,	
sure,	सूरे,	श्योर,	
jamaaya,	जमाया,	जमाया,	
chimti,	चिमटी,	चिमटी,	
vibhajak,	विभाजक,	विभाजक,	
raidical,	रेडिकल,	रैडिकल,	
duvidhaaen,	दुविधाएं,	दुविधाएं,	
aasan,	आसन,	आसान,	
programers,	प्रोग्रामर्स,	प्रोग्रामर्स,	
bharate,	भररते,	भरते,	
basava,	बसवा,	बसावा,	
denevaali,	देनेवाली,	देनेवाली,	
bahawalpur,	बहवालपुर,	बहावलपुर,	
benvar,	बेनवर,	बेंवर,	
pisa,	पिसा,	पीसा,	
avrodhk,	अवरोधक,	अवरोधक,	
mahakane,	महककने,	महकने,	
parnel,	पर्नेल,	पार्नेल,	
clock,	क्लॉक,	क्लाक,	
moody,	मूडी,	मूडी,	
asian,	एशियाई,	एशियन,	
emelon,	इमलों,	ईमेलों,	
phodo,	फोडो,	फोड़ों,	
sanyukta,	सानुयक्त,	संयुक्ता,	
brigton,	ब्रिगटन,	ब्रिगटन,	
mariya,	मरिया,	मारिया,	
aabru,	आबरू,	आबरू,	
taaza,	ताजा,	ताजा,	
kusumalataa,	कुसुमालता,	कुसुमलता,	
barpaya,	बर्पाया,	बरपाया,	
agyat,	अज्ञात,	अज्ञात,	
dhyeyavaadi,	ध्यायवादी,	ध्येयवादी,	
bani,	बानी,	बानी,	
sapney,	सपने,	सपने,	
sneakers,	स्नेकर्स,	स्नीकर्स,	
nagaada,	नगदा,	नगाड़ा,	
shaly,	शल्य,	शैली,	
chandu,	चंंडू,	चंदू,	
thaile,	थैले,	थैले,	
wipro,	विप्रो,	विप्रो,	
ganthen,	गंथें,	गांठें,	
angarak,	अंगरक,	अंगारक,	
dardraa,	दर्दरा,	दरदरा,	
alayans,	अल्यास,	अलायंस,	
dubona,	डूबोना,	डुबोना,	
praakkathan,	प्राक्थन,	प्राक्कथन,	
notes,	नोटेस,	नोट्स,	
james,	जमेस,	जेम्स,	
daanshil,	दानशील,	दानशील,	
vipritata,	विप्रितता,	विपरीतता,	
aithan,	ऐंठन,	ऐठन,	
malar,	मालर,	मलार,	
jatiyon,	जातियों,	जातियों,	
katthaii,	कट्ठाई,	कत्थई,	
milkiyat,	मिलकियत,	मिल्कियत,	
jamuai,	जमुआई,	जमुई,	
sanvedikaran,	संवेदीकरण,	संवेदीकरण,	
manipal,	मनिपाल,	मणिपाल,	
pib,	पीब,	पीआईबी,	
shmil,	शमील,	शमिल,	
have,	हेवे,	हैव,	
jiyo,	जियो,	जीयो,	
bakhshane,	बख्शने,	बख्शने,	
mukarte,	मुकररते,	मुकरते,	
pruf,	प्रूफ,	प्रूफ,	
vastvik,	वास्तविक,	वास्तविक,	
pardesi,	परदेशी,	परदेसी,	
ravel,	रेवल,	रवैल,	
dikhayin,	दिखाइं,	दिखाईं,	
aswbhavik,	असभभाविक,	अस्वभाविक,	
laurence,	लारेंस,	लौरेंस,	
pharth,	फर्थ,	फर्थ,	
adhiik,	अधिक,	अधीक,	
adhiwas,	अधिवास,	अधिवास,	
nokri,	नोकरी,	नोकरी,	
lakshy,	लक्ष्य,	लक्ष्य,	
harijan,	हरिजन,	हरिजन,	
chhudaane,	छुड़ाने,	छुडाने,	
kanishthikaa,	कनिष्ठिका,	कनिष्ठिका,	
granite,	ग्रेनिट,	ग्रेनाइट,	
bhrantiyon,	भ्रंतियों,	भ्रांतियों,	
rugnata,	रूग्णता,	रुग्णता,	
boliae,	बोलियाई,	बोलिए,	
deputy,	डिप्टी,	डेप्युटी,	
celery,	सेलरी,	सैलरी,	
haito,	हैटो,	हैतो,	
sahuliyat,	सहूलियत,	सहूलियत,	
classon,	क्लासन,	क्लासों,	
sabmission,	सब्मिशन,	सबमिशन,	
madhupur,	मधुपुर,	मधुपुर,	
chhati,	छती,	छाती,	
prakshepak,	प्रक्षेपक,	प्रक्षेपक,	
luxor,	लुकूर,	लक्सर,	
mhavidya,	महाविद्य,	महाविद्या,	
dirham,	दीरहाम,	दिरहम,	
risane,	रिसने,	रिसने,	
thumari,	थुमरी,	ठुमरी,	
aastik,	आस्तिक,	आस्तिक,	
chaurai,	चौराई,	चौरई,	
achnera,	अचनेरा,	अछनेरा,	
atthas,	अत्थास,	अट्टहास,	
moolchand,	मूलचंद,	मूलचंद,	
november,	न्वेबर,	नवंबर,	
khand,	खंंड,	खंडा,	
oxide,	ऑक्सीइड,	ऑक्साइड,	
mardangi,	मारंगिंी,	मर्दानगी,	
mahamantr,	महामंत्र,	महामंत्र,	
sathsath,	सतथसथथ,	साथसाथ,	
dradh,	द्राध,	दृढ़,	
bandej,	बैंदेज,	बैंडेज,	
udaa,	उड़ा,	उदा,	
deepika,	दीपिका,	दीपिका,	
bahroopiya,	बहरूपिय,	बहरूपिया,	
agnat,	अज्ञात,	अज्ञात,	
sanshyon,	संश्यों,	संशयों,	
kasara,	कसरा,	कसारा,	
rozlyn,	रॉजलीन,	रोजलिन,	
dayitva,	दायित्व,	दायित्व,	
holding,	होल्डिंग,	होल्डिंग,	
manchiy,	मांचीय,	मंचीय,	
vyapak,	व्यापक,	व्यापक,	
help,	हेल्प,	हेल्प,	
darjano,	दरजानों,	दर्जनों,	
taras,	तारस,	तरस,	
broke,	ब्रॉक,	ब्रोक,	
grandhiyon,	ग्रांधियों,	ग्रंथियों,	
cricketer,	क्रिक्टर,	क्रिकेटर,	
symons,	सामंस्स,	साइमंस,	
galgand,	गालांड,	गलगंड,	
bhayo,	भायो,	भयो,	
jhuthalane,	झुठलाने,	झुठलाने,	
dabholkar,	दाभोलकार,	दाभोलकर,	
najeeb,	नजीब,	नजीब,	
offers,	ऑफर्स,	ऑफर्स,	
alind,	अलिंड,	अलिंद,	
vichaarakon,	विचारकों,	विचारकों,	
tantro,	टंत्रों,	तंत्रों,	
last,	लास्ट,	लास्ट,	
kumau,	कुमाऊ,	कुमाऊ,	
virodhabhasi,	विरोदाभासी,	विरोधाभासी,	
pachaataa,	पचाता,	पचाता,	
jayalalita,	जयलालिता,	जयललिता,	
palari,	पलारी,	पलारी,	
wrapping,	र्पैपिंग,	रैपिंग,	
soochak,	सूचक,	सूचक,	
jadeite,	जड़िते,	जड़ित,	
enzyme,	एनजीम,	एंजाइम,	
putaliyon,	पुटलियों,	पुतलियों,	
lindn,	लिंडन,	लिंडन,	
madaura,	मदौरा,	मढ़ौरा,	
unatees,	यननीसीस,	उनतीस,	
purzon,	पुरजों,	पुर्जों,	
lairi,	लारि,	लैरी,	
avrodhak,	अवरोधक,	अवरोधक,	
pages,	पेगेस,	पेजेज,	
pearson,	पीर्सन,	पियरसन,	
sunaseer,	सुनासीर,	सुनासीर,	
roopi,	रूपी,	रूपी,	
kardhe,	कर्ढे,	करघे,	
thumri,	थूमरी,	ठुमरी,	
rabin,	रबीन,	राबिन,	
dalbadal,	दलबदल,	दलबदल,	
dvadash,	द्वदश,	द्वादश,	
bechate,	बेचते,	बेचते,	
anant,	अनांट,	अनंत,	
atharva,	अथर्ावा,	अथर्व,	
pathyakram,	पाठयक्रम,	पाठ्यक्रम,	
kanti,	कांी,	कांति,	
bule,	बुले,	बुले,	
seto,	सीटो,	सेटो,	
bharane,	भरने,	भरने,	
liidaron,	लींडरों,	लीडरों,	
cadmium,	कैडमियम,	कैडमियम,	
hanfte,	हैंफ्टे,	हांफते,	
janahaani,	जननाहि,	जनहानि,	
falne,	फलने,	फलने,	
kathore,	कथोरे,	कठोर,	
jin,	जिन,	जिन,	
vaishaakhi,	वैशाखी,	वैशाखी,	
girjagharon,	गिरजाघरों,	गिरजाघरों,	
byaawa,	बयावा,	ब्यावर,	
agr,	एग्र,	अग्र,	
chest,	चेस्ट,	चेस्ट,	
neta,	नेता,	नेता,	
puru,	पुरू,	पुरू,	
jai,	जाई,	जय,	
dvivedi,	द्विवेदी,	द्विवेदी,	
bajaj,	बजजज,	बजाज,	
zarda,	ज़रदा,	जर्दा,	
kasim,	कासिम,	कासिम,	
vladimir,	व्लाीीमीर,	व्लादिमीर,	
ilayichi,	इलाइिी,	इलाइची,	
oran,	ओरन,	ओरण,	
tarkvaad,	तर्कवाद,	तर्कवाद,	
karykartaaon,	कार्यककत्ाओं,	कार्यकर्ताओं,	
soy,	सोय,	सोय,	
rihanna,	रिहनना,	रिहाना,	
kundaliyan,	कुंडलियां,	कुंडलियाँ,	
maxico,	मैक्सिको,	मेक्सिको,	
generic,	जेनेकिक,	जेनरिक,	
maulaviyon,	मौलवियों,	मौलवियों,	
vesh,	वेश,	वेश,	
ghost,	घोस्ट,	घोस्ट,	
tyoihar,	त्योहार,	त्यौहार,	
galaxyon,	गैलक्सों,	गैलेक्सियों,	
luis,	लुई,	लुईस,	
dhoondh,	ढूंध,	ढूंढ,	
jacks,	जेक्स,	जैक्स,	
sudip,	सुदीप,	सुदीप,	
sunaron,	सुनारों,	सुनारों,	
tarash,	तारश,	तराश,	
taste,	तस्ते,	टेस्ट,	
kanyaayen,	कन्यायें,	कन्याएं,	
pahnati,	पहनती,	पहनाती,	
pmo,	प्मो,	पीएमओ,	
formule,	फॉर्मूल,	फार्मूले,	
dhamma,	धम्म,	धम्मा,	
pradhyapakon,	प्राध्यापों,	प्राध्यापकों,	
elaaj,	इलाज,	इलाज,	
jenner,	जेनर,	जेनर,	
sabhen,	सभें,	सभाएं,	
mezbaan,	मेबबान,	मेजबान,	
gaumutra,	गौमुत्र,	गौमूत्र,	
packajon,	पक्कजों,	पैकेजों,	
saga,	सागा,	सागा,	
darate,	डरते,	डराते,	
siyasi,	सियासी,	सियासी,	
bhumi,	भूमि,	भूमी,	
deepn,	दीपन,	दीपन,	
pijja,	पिज्ज़ा,	पिज्जा,	
sawal,	सवाल,	सवाल,	
kocchi,	कोची,	कोच्चि,	
yda,	यड़ा,	यदा,	
pakshapat,	पश्षपपत,	पक्षपात,	
apj,	अपजज,	एपीजे,	
cavalry,	कैवलरी,	कैवेलरी,	
vigyanon,	विज्ञानों,	विज्ञानों,	
bhadkaayaa,	भड़काया,	भड़काया,	
sametati,	समेटती,	समेटती,	
bageechi,	बगीीी,	बगीची,	
thailee,	थैली,	थैली,	
judae,	जुदाए,	जुड़ाई,	
channa,	चन्ना,	चन्ना,	
roojwelt,	रूज़वेल्ट,	रुजवेल्ट,	
jivraj,	जीवराज,	जीवराज,	
fact,	फैक्ट,	फैक्ट,	
dharmesh,	धर्मेश,	धर्मेश,	
jajmauu,	जजमाऊ,	जाजमऊ,	
rajkot,	राजकोत,	राजकोट,	
chhuree,	छुरी,	छुरी,	
gatishil,	गतिशील,	गतिशील,	
mamooli,	मामूली,	मामूली,	
datsun,	दत्सुन,	डैटसन,	
africa,	अफ्रीका,	अफ्रीका,	
kaju,	काजू,	काजू,	
melghat,	मेलघात,	मेलघाट,	
karybhar,	कार्यभार,	कार्यभार,	
wolv,	वोल्व,	वाल्व,	
marwar,	मारवार,	मारवाड़,	
vidhut,	विद्युत,	विधुत,	
ardas,	अर्दास,	अरदास,	
denewali,	देनेवाली,	देनेवाली,	
pml,	पीएमएल,	पीएमएल,	
pichhade,	पिछड़े,	पिछड़े,	
nichalaa,	निचला,	निचला,	
rosariyo,	रोसरियों,	रोसारियो,	
narsanharon,	नरसंहहरों,	नरसंहारों,	
kamau,	कामऊ,	कमाऊ,	
fodo,	फोडो,	फोड़ों,	
banvaa,	बनवा,	बनवा,	
hilne,	हिलने,	हिलने,	
utane,	उताने,	उतने,	
jvaaron,	ज्वरों,	ज्वारों,	
chaupati,	चौपती,	चौपाटी,	
vaan,	वान,	वाण,	
vivekahin,	विवेकाहीन,	विवेकहीन,	
gudna,	गुड़ना,	गुदना,	
vatar,	वातर,	वाटर,	
jiwan,	जीवन,	जीवन,	
tremasik,	ट्रेमैसिक,	त्रैमासिक,	
baldwin,	बलल्वीन,	बाल्डविन,	
vaimanya,	वैमान्य,	वैमनस्य,	
mariyo,	मारियो,	मारियो,	
suction,	सक्शन,	सक्शन,	
gandh,	गंंध,	गंध,	
samprbhuta,	संप्रभूता,	संप्रभुता,	
premi,	प्रेमी,	प्रेमी,	
kaldvel,	काल्वेल,	काल्डवेल,	
charchaon,	चर्चाओं,	चर्चाओं,	
chandan,	चंदन,	चंदन,	
cleris,	क्लेरिस,	क्लेरिस,	
aradas,	अरदद,	अरदास,	
hawamahal,	हवाहहल,	हवामहल,	
charton,	चर्तों,	चार्टों,	
asvabhavik,	अस्वाभाविक,	अस्वभाविक,	
mohini,	मोहिनी,	मोहिनी,	
patavaari,	पतवारी,	पटवारी,	
dayitwa,	दययत्व,	दायित्व,	
arushi,	अरूषी,	आरुषि,	
vyabhichari,	व्याभिचारी,	व्यभिचार,	
alankar,	अलंकर,	अलंकार,	
jeneva,	जेनेवा,	जिनीवा,	
pakhandi,	पाखंडी,	पाखंडी,	
gomke,	गोमके,	गोमके,	
rawail,	रवैल,	रवैल,	
bandhati,	बांधती,	बंधती,	
marrej,	मररेज,	मैरेज,	
kamottejna,	कामोत्ञेन,	कामोत्तेजना,	
pakshpaat,	पश्षपत,	पक्षपात,	
want,	वांट,	वांट,	
sthoolta,	स्थूलता,	स्थूलता,	
navya,	नव्य,	नव्या,	
ghummakkadon,	घुममकककोंों,	घुमक्कड़ों,	
siddhvat,	सिद्धववत,	सिद्धवट,	
tuglakabad,	तुग्लाबाब,	तुगलकाबाद,	
cubeck,	क्ब्क,	क्यूबेक,	
dum,	डम,	डम,	
doongarpur,	दूनरपरर,	डूंगरपुर,	
putlaa,	पुटला,	पुतला,	
chheter,	छेत्र,	छेत्र,	
torch,	तोर्च,	टार्च,	
hasinon,	हासिनों,	हसीनों,	
thikane,	ठिकने,	ठिकाने,	
rampur,	रामपुर,	रामपुर,	
tenis,	टेनिस,	टेनिस,	
bhay,	भय,	भय,	
vise,	वाइस,	वाइज,	
fatma,	फतताम,	फातमा,	
udan,	उड़न,	उड़ान,	
peetne,	पीटने,	पीटने,	
astik,	एस्तिक,	आस्तिक,	
sean,	सीन,	शॉन,	
bhav,	भाव,	बहाव,	
goel,	गोल,	गोयल,	
megapixal,	मैगेपिकल,	मेगापिक्सल,	
reza,	रेजा,	रेजा,	
durbhiksh,	दुरभिक्ष,	दुर्भिक्ष,	
algavvadi,	अल्वववादी,	अलगाववादी,	
ropne,	रोपने,	रोपने,	
wireless,	वायरलेस,	वायरलेस,	
angarh,	अंगढ़,	अनगढ़,	
gosvami,	गोस्वामी,	गोस्वामी,	
besil,	बेसिल,	बेसिल,	
ghunsa,	घुंसा,	घूंसा,	
lati,	लतटी,	लाती,	
suchak,	सुचा,	सूचक,	
