jad,	जड़,	जड़,	
shanghai,	शांघाई,	शंघाई,	
gin,	गिन,	जिन,	
mithya,	मिथ्या,	मिथ्या,	
nanaa,	नाना,	नना,	
atwaal,	अत्वाल,	अटवाल,	
module,	मॉडुले,	मॉड्यूल,	
bakhshane,	बख़शाने,	बख्शने,	
chaurai,	चौराई,	चौरई,	
baksa,	बकसा,	बक्सा,	
anavshyak,	अनावश्यक,	अनावश्यक,	
besin,	बेसीन,	बेसिन,	
sanyog,	संयोग,	संयुक्त,	
lidaron,	लिदारों,	लीडरों,	
phaaph,	फाफ,	फाफ,	
aastik,	आस्तिक,	आस्तिक,	
suraj,	सुराज,	सूरज,	
swaarthparak,	स्वार्थपरर,	स्वार्थपरक,	
maulviyon,	मौलवियों,	मौलवियों,	
cric,	क्रिक,	क्रिक,	
prayaasrat,	प्रयास्रत,	प्रयासरत,	
thakkar,	ठक्कर,	ठक्कर,	
saja,	सजा,	साजा,	
naakaam,	नाकाम,	नाकाम,	
chanan,	चानन,	चानन,	
putale,	पुताले,	पुतले,	
daanshil,	दानशील,	दानशील,	
fabti,	फबती,	फब्ती,	
aparivartansheel,	अपरिवर्तनशील,	अपरिवर्तनशील,	
rasayanika,	रासायनिका,	रसायनिक,	
vaigyanik,	वैग्ञानिक,	वैज्ञानिक,	
samshayon,	सम्षायों,	संशयों,	
ishara,	इशारा,	इशारा,	
sthiti,	स्थिति,	स्तिथि,	
ladaeyon,	लड़ाएं,	लड़ाईयों,	
achyut,	अछूत्य,	अच्युत,	
speller,	स्पेलर,	स्पेलर,	
shawn,	शान,	शॉन,	
robinson,	रॉबिंसन,	रॉबिंसन,	
raubdar,	राउबर,	रौबदार,	
sarguja,	सरगुजा,	सरगुजा,	
sthul,	स्थुल,	स्थूल,	
tani,	तानी,	तनी,	
keynote,	केनोट,	कीनोट,	
tanbe,	तंबे,	तांबे,	
vishwasaniyata,	विश्वासनीयता,	विश्वसनीयता,	
aset,	असेत,	असेट,	
cps,	सीपीस,	सीपीएस,	
najron,	नजरों,	नजरों,	
najarandaaj,	नजरअंदाज़,	नजरंदाज,	
anukulta,	अनुकुलता,	अनुकूलता,	
nanhe,	नन्हे,	नन्हें,	
amadan,	अमददन,	आमदन,	
rovan,	रोवन,	रोवन,	
parvaa,	परवा,	परवा,	
alayans,	अलयांस,	अलायंस,	
baawaraa,	बावरा,	बावरा,	
sevakon,	सेवकों,	सेवकों,	
sambhrant,	संभ्रांत,	संभ्रांत,	
tahi,	तही,	ताहि,	
sim,	सिम,	सिम,	
federal,	फेडरल,	फैडरल,	
thitron,	ठित्रों,	थियेटरों,	
darul,	दारुल,	दारूल,	
sagarika,	सागरिका,	सागरिका,	
cute,	कूट,	क्यूट,	
supachya,	सुपाच्य,	सुपाच्य,	
raaji,	राजी,	राजी,	
luis,	लुईस,	लुईस,	
lenewali,	लेनेवाली,	लेनेवाली,	
wasting,	वास्टिंग,	वेस्टिंग,	
cigaretton,	सिगरेट्ं,	सिगरेटों,	
baalti,	बालती,	बाल्टी,	
failaea,	फैलाए,	फैलाइए,	
modyuls,	मॉडल्स,	मॉड्यूल्स,	
takaraon,	टकराओं,	टकरावों,	
falitarth,	फलीतररथ,	फलितार्थ,	
senvai,	सेनवाई,	सेंवई,	
urwarta,	उर्वरता,	उर्वरता,	
chauguni,	चौगुनी,	चौगुनी,	
satane,	सतने,	सताने,	
aprihary,	अपरिहार्य,	अपरिहार्य,	
ganthon,	गंथों,	गांठों,	
slash,	स्लैश,	स्लैश,	
dvc,	डीवीसी,	डीवीसी,	
chero,	चेरो,	चेरो,	
tareeko,	तरीको,	तरीको,	
shooting,	शूटिंग,	शुटिंग,	
mohini,	मोहिनी,	मोहिनी,	
avishvasniy,	अविश्वस्नीय,	अविश्वसनीय,	
tarabganj,	तर्बंगज,	तरबगंज,	
udar,	उदार,	उदर,	
saanketika,	सांकेतिका,	सांकेतिक,	
gyatavya,	ज्यातव्य,	ज्ञातव्य,	
lte,	एलटी,	एलटीई,	
shriram,	श्रीरम,	श्रीराम,	
wattson,	वैट्सन,	वाटसन,	
jaibaan,	जायबन,	जयबाण,	
dukhan,	दुखान,	दुखन,	
ekthi,	एक्ठी,	इकठ्ठी,	
dhaarak,	धारक,	धारक,	
lagnewale,	लगनेवाले,	लगनेवाले,	
khaini,	खैनी,	खैनी,	
carfi,	कार्फी,	कार्की,	
pammi,	पाम्मी,	पम्मी,	
aajmana,	आजमना,	आजमाना,	
agavai,	अगवाई,	अगवाई,	
jalbharav,	जलभारव,	जलभराव,	
bhookhi,	भूखी,	भूखी,	
deewani,	दीवानी,	दिवानी,	
atkata,	अटकता,	अटकता,	
dhairyavaan,	धैर्यवान,	धैर्यवान,	
aashanka,	आशांका,	आशंका,	
dhoron,	धोरों,	धोरों,	
pied,	पायड,	पाइड,	
singhde,	सिंहड़े,	सिंघाड़े,	
simatataa,	सीमतता,	सिमटता,	
dhona,	ढोना,	धोना,	
barat,	बरात,	बरात,	
kanishtika,	कनिष्टिका,	कनिष्ठिका,	
sahooliyata,	सहूलियता,	सहूलियत,	
bhumika,	भूमिका,	भूमी,	
pachata,	पचाता,	पचाता,	
chadaron,	चद्रों,	चादरों,	
alind,	आलिंड,	अलिंद,	
rajma,	रजमा,	राजमां,	
dhasmana,	धासमान,	धस्माना,	
chalit,	चलित,	चालित,	
tagade,	तगड़े,	तगड़े,	
sanyukt,	सानयुक्त,	संयुक्त,	
slider,	स्लाइडर,	स्लाइडर,	
aloso,	एलोस,	अलोंसो,	
patili,	पतिली,	पतीली,	
gajipur,	गाज़ीपुर,	गाजीपुर,	
vitthal,	वित्थल,	विट्ठल,	
firmian,	फर्मियां,	फर्मिऑन,	
mulon,	मूलों,	मूलों,	
bhutal,	भूताल,	भूतल,	
khaastaur,	खासतौर,	ख़ासतौर,	
rhamat,	रहमत,	रहमत,	
ikhrul,	इखरूल,	उखरुल,	
sprit,	स्प्रित,	स्प्रिट,	
mumba,	मुंबा,	बंबा,	
akapulko,	अकापुलको,	अकापुल्को,	
chhuree,	छुरी,	छुरी,	
bajrangi,	बजरंगी,	बजरंगी,	
elaichi,	एलाईछी,	इलाइची,	
jayalalita,	जयालालिता,	जयललिता,	
avisvasniya,	अविस्वासीय,	अविश्वसनीय,	
kankar,	कनकर,	कंकड़,	
anyay,	अन्याय,	अन्याय,	
devapur,	देवपुर,	देवापुर,	
jeneva,	जेनेवा,	जिनीवा,	
pythogaras,	पिथोगारास,	पाइथागोरस,	
sierra,	सियरा,	सिएरा,	
karanj,	करंज,	करंज,	
jatakon,	जटकों,	जातकों,	
piki,	पीकी,	पिकी,	
asphalt,	असफलत,	एस्फाल्ट,	
lti,	एलटी,	एलटीई,	
ralod,	रालोड,	रालोद,	
antaha,	अंताहा,	अंतः,	
ladate,	लड़ते,	लड़ते,	
sutali,	सुतली,	सुतली,	
jeevraaj,	जीवराज,	जीवराज,	
thaile,	थाइले,	थैले,	
teekamgarh,	टीकमगढ़,	टीकमगढ़,	
apnani,	अपनानी,	अपनानी,	
somi,	सोमी,	सोमी,	
amarpaal,	अमरपाल,	अमरपाल,	
jhuthalane,	झुठलाने,	झुठलाने,	
maisachusets,	मैसाचेस्ट्स,	मैसाचुसेट्स,	
ladai,	लड़ाई,	लड़ाई,	
algavwaadi,	अलगवावड़ी,	अलगाववादी,	
naagrik,	नागरिक,	नागारिक,	
alankaron,	अलंकारों,	अलंकारों,	
cricketing,	क्रिकटिंग,	क्रिकेटिंग,	
niketan,	निकेटन,	निकेतन,	
parlouron,	पार्लोरों,	पार्लरों,	
recreation,	रिक्रेशन,	रिक्रिएशन,	
maas,	मास,	मास,	
raktabh,	रक्तभ,	रक्ताभ,	
bhumi,	भूमि,	भूमी,	
shrikar,	श्रीकार,	श्रीकर,	
aadharit,	आधारित,	आधारित,	
danptiyon,	दांपतियों,	दंपतियों,	
bagad,	बगगड़,	बगड़,	
aryon,	आर्यों,	आर्यों,	
failkar,	फैलकर,	फैलकर,	
prahsan,	प्रहसन,	प्रहसन,	
mahasinh,	महासिंह,	महासिंह,	
vellur,	वेल्यूर,	वेल्लूर,	
chuka,	चूका,	चौका,	
catholicon,	कैथलिकों,	कैथोलिकों,	
belcha,	बेलचा,	बेलचा,	
audyogikikaran,	औद्योगिकीर्ण,	औद्योगिकरण,	
pajej,	पजेज,	पेजेज,	
chipakne,	चिपकने,	चिपकने,	
khilana,	खिलना,	खिलाना,	
farrukhabad,	फररखाबाद,	फर्रुखाबाद,	
benvar,	बेंवर,	बेंवर,	
hijada,	हिजड़ा,	हिजड़ा,	
waan,	वान,	वाण,	
jurab,	जुराब,	जुराब,	
mejban,	मेजबन,	मेज़बान,	
theatron,	ठीटरों,	थियेटरों,	
ajhar,	अजर,	अजहर,	
atharv,	अथर्व,	अथर्व,	
taajaa,	ताजा,	ताजा,	
azhar,	अज़ार,	अजहर,	
equador,	एक्वायडर,	इक्वाडोर,	
tyohar,	त्योहार,	त्यौहार,	
ester,	एस्टर,	एस्टर,	
virajati,	विराजति,	विराजती,	
less,	लेस,	लैस,	
virodhabhason,	विरोधाभासों,	विरोधाभासों,	
moolon,	मूलों,	मूलों,	
thahrane,	ठहराने,	ठहरने,	
khastaur,	खासतौर,	ख़ासतौर,	
roni,	रोनी,	रोनी,	
sarkarein,	सरकारें,	सरकारें,	
vadali,	वादली,	वडाली,	
junior,	जुनियर,	जूनियर,	
baniya,	बनिया,	बनिया,	
pitne,	पिटने,	पीटने,	
sthulata,	स्थुलता,	स्थूलता,	
halchaal,	हलचाल,	हालचाल,	
dirham,	दिरहम,	दिरहम,	
duvidhaayein,	दुविधाएं,	दुविधाएं,	
melghat,	मेलघट,	मेलघाट,	
mariyo,	मरियो,	मारियो,	
lakme,	लक्मे,	लक्मे,	
labelling,	लेबलिंग,	लेबलिंग,	
jamaaya,	जमाया,	जमाया,	
shasak,	शासक,	शासक,	
patki,	पटकी,	पटकी,	
bichhuaa,	बिछुआ,	बिछुआ,	
udant,	उदांत,	उदंत,	
tapuon,	तापुओं,	टापुओं,	
loge,	लोग,	लोगे,	
kabaddi,	कबादड़ी,	कबड्डी,	
maddy,	मैड्डी,	मैडी,	
putla,	पुत्ला,	पुतला,	
aurangabad,	औरंगाबाद,	औरंगाबाद,	
brijesh,	बृजेश,	बृजेश,	
rishicool,	ऋिशिल,	ऋषिकुल,	
chauki,	चौकी,	चौकी,	
paarshadon,	पार्शदों,	पार्षदों,	
dredger,	ड्रेजर,	ड्रेजर,	
bageechi,	बगीची,	बगीची,	
sudip,	सुदीप,	सुदीप,	
durghatna,	दुर्घटना,	दुर्घटना,	
bulaao,	बुलाओ,	बुलाओ,	
pedia,	पेडिया,	पीडिया,	
nityaa,	नित्या,	नित्या,	
baag,	बाग,	बाग,	
taobao,	ताबाओ,	टैबू,	
maryokar,	मर्योकार,	मयोर्का,	
chai,	चाई,	छै,	
avashist,	अवशिष्ट,	अवशिष्ट,	
malish,	मलीश,	मालिश,	
sweekarte,	स्वीकारते,	स्वीकारते,	
kapolkalpana,	कपोलकल्पन,	कपोलकल्पना,	
dah,	दह,	दाह,	
hawalaat,	हवलात,	हवालात,	
khayen,	खाएं,	खाएं,	
bharatnatyam,	भारतनाट्यम,	भरतनाट्यम्,	
jassee,	जस्सी,	जस्सी,	
niveshkarta,	निवेषकर्ता,	निवेशकर्ता,	
piega,	पीगा,	पिएगा,	
sanyukta,	सानयुक्त,	संयुक्ता,	
sapate,	सपते,	सपाटे,	
koling,	कोलिंग,	कोलिंग,	
fansi,	फांसी,	फांसी,	
sure,	सूरे,	श्योर,	
bangbhang,	बंगभांग,	बंगभंग,	
lambi,	लांबी,	लंबी,	
divy,	दिवी,	दिव्य,	
fuji,	फूजी,	फ्यूजी,	
bethanal,	बेथनाल,	बेथनल,	
spf,	एसपीएफ,	एसपीएफ,	
darmiyan,	दरमियां,	दरमियान,	
kalmen,	कालमेन,	कलमें,	
jankaron,	जानकरों,	जानकारों,	
chandana,	चांदाना,	चंदन,	
khate,	खाते,	खाते,	
chhinke,	छीनके,	छींके,	
purvaabhaas,	पूर्वाभास,	पूर्वाभास,	
packard,	पैकार्ड,	पैकर्ड,	
alive,	एलाइव,	अलाइव,	
vibhrm,	विभ्रम,	विभ्रम,	
manchit,	मांचित,	मंचित,	
byrun,	बारून,	बायर्न,	
welwet,	वेलवेट,	वेलवेट,	
sanvedikaran,	संवेदिकरण,	संवेदीकरण,	
jasper,	जैप्पर,	जैस्पर,	
sohawal,	सोहावल,	सोहावल,	
symons,	सायमंस,	साइमंस,	
rumani,	रूमानी,	रुमानी,	
sfoorti,	स्फूर्ती,	स्फूर्ति,	
ladaai,	लड़ाई,	लड़ाई,	
rangkata,	रांगकता,	रंजकता,	
maangi,	मांगी,	मांगी,	
gowmutra,	गोममुत्र,	गौमूत्र,	
putaliyaan,	पुतालियां,	पुतलियां,	
kundal,	कुंडल,	कुंडल,	
ludhkate,	लुढ़कते,	लुढ़कते,	
timer,	टाइमर,	टाइमर,	
faaf,	फाफ,	फाफ,	
should,	शोल्ड,	शुड,	
ipad,	इपाद,	आईपैड,	
piyegaa,	पीयगा,	पिएगा,	
jaaunch,	जांच,	जाँच,	
ravel,	रेवल,	रवैल,	
ligar,	लिगार,	लिगर,	
shin,	शीन,	क्षीण,	
pataakshep,	पटाक्षेप,	पटाक्षेप,	
jiniva,	जिनिवा,	जिनीवा,	
charit,	चरित,	चरित,	
khatakati,	खटकती,	खटकती,	
mubarkpur,	मुबर्कपुर,	मुबारकपुर,	
gazipur,	गाज़ीपुर,	गाजीपुर,	
wireless,	वायरलेस,	वायरलेस,	
vanshvaad,	वंश्वाद,	वंशवाद,	
ved,	वेद,	वेड,	
favvara,	फववारा,	फव्वारा,	
lodi,	लोडी,	लोदी,	
brighton,	ब्राइटन,	ब्रिगटन,	
trubyunal,	ट्र्बुयुनल,	ट्रिब्यूनल,	
deji,	देजी,	डेजी,	
mariya,	मरिया,	मारिया,	
malar,	मालर,	मलार,	
sparivar,	स्परिवार,	सपरिवार,	
naxalvaaad,	नक्लवाद,	नक्सलवाद,	
chauk,	चौक,	चौक,	
forcee,	फोर्सी,	फारसी,	
ravael,	रावैल,	रवैल,	
bharakaya,	भड़काया,	भड़काया,	
lalak,	लालक,	ललक,	
swikarte,	स्वीकार्टे,	स्वीकारते,	
pushkarnaa,	पुष्करण,	पुष्करणा,	
makhdumpur,	मखदमुपुर,	मखदुमपुर,	
kisani,	किसनी,	किसानी,	
venezuela,	वेंजिला,	वेनेजुएला,	
trap,	ट्रेप,	ट्रैप,	
gopichand,	गोपीचंद,	गोपीचंद,	
bekabu,	बेकाबू,	बेकाबू,	
choron,	चोरों,	चोरों,	
semen,	सीमेन,	सेमिन,	
vanita,	वनीता,	वनिता,	
lagna,	लगना,	लगना,	
janaganna,	जननानन,	जनगणना,	
bells,	बेल्स,	बैल्स,	
samanjasya,	समाजजास्या,	सामंजस्य,	
alai,	अलाई,	अली,	
ethan,	एथान,	ऐठन,	
iris,	आईरिस,	आईरिस,	
nagin,	नगगीन,	नागिन,	
lycopene,	लिकोपाइन,	लाइकोपिन,	
dikhaai,	दिखाई,	दिखाई,	
carat,	कराट,	कैरेट,	
khurasan,	खुरसन,	खुरासान,	
navjaagaran,	नवजागरण,	नवजागरण,	
ghisi,	घीसी,	घिसी,	
mas,	मस,	मास,	
phoos,	फूस,	फूस,	
raith,	राठ,	रैथ,	
jogging,	जोगिंग,	जॉगिंग,	
ikatthi,	इकट्ठी,	इकठ्ठी,	
antoni,	अंटोनी,	एंटोनी,	
engineer,	इंजीनियर,	इंजिनियर,	
jamui,	जमुई,	जमुई,	
aavishakaar,	आविषाकार,	आविष्कार,	
aayojak,	आयोजक,	आयोजक,	
joddta,	जोड़ता,	जोड़ता,	
dalbadl,	दलबदल,	दलबदल,	
mod,	मोड,	मॉड,	
vaadiyon,	वादियों,	वादियों,	
niptaara,	निपटारा,	निपटारा,	
gyatvy,	ज्यातव्य,	ज्ञातव्य,	
client,	क्लाइंट,	क्लांइट,	
teap,	टीप,	टिप,	
pahnati,	पहनती,	पहनाती,	
nikaalni,	निकालनी,	निकालनी,	
dastana,	दस्ताना,	दस्ताना,	
dhokebaj,	धोकेबाज,	धोखेबाज,	
kasara,	कसरा,	कसारा,	
pokar,	पोकार,	पोकर,	
lakshyon,	लक्ष्यों,	लक्ष्यों,	
duvidhaen,	दुविधाएं,	दुविधाएं,	
bhira,	भीरा,	भीरा,	
uski,	उसकी,	उसकी,	
kush,	कुश,	कुश,	
stuti,	स्टूटी,	स्तुति,	
falta,	फलता,	फलता,	
usaki,	उसकी,	उसकी,	
khachakhach,	खच्चाच,	खचाखच,	
aliens,	एलाइंस,	एलियंस,	
blossom,	ब्लॉसम,	ब्लॉसम,	
destination,	डेस्टिनेशन,	डेस्टिनेशन,	
ecuador,	इक्वायडर,	इक्वाडोर,	
birganj,	बीरगंज,	बीरगंज,	
samprbhuta,	संप्रभूत,	संप्रभुता,	
santati,	संतती,	संतति,	
dhatana,	धातना,	धटना,	
sandrbh,	संद्रभ,	संदर्भ,	
bounceron,	बाउंसरों,	बाउंसरों,	
suneyga,	सुनेगा,	सुनेगा,	
batalvi,	बतलवी,	बटालवी,	
alochak,	आलोचक,	आलोचक,	
simate,	सिमते,	सिमटे,	
riya,	रिया,	रिया,	
ranapur,	रणपुर,	रानापुर,	
banu,	बानु,	बनू,	
chee,	ची,	ची,	
saptari,	सप्तारी,	सप्तरी,	
bilhaur,	बिल्हौर,	बिल्हौर,	
sev,	सेव,	सेव,	
anthak,	अंथक,	अनथक,	
upakhyanon,	उपख्यानों,	उपाख्यानों,	
spma,	एसपीएम,	सोमा,	
jeevan,	जीवन,	जीवन,	
angarh,	अंगऱ,	अनगढ़,	
karykartaon,	कार्यकर्ताओं,	कार्यकर्ताओं,	
agnat,	अज्ञात,	अज्ञात,	
perabola,	पेराबोला,	पैराबोला,	
nicky,	निकी,	निकी,	
gaumutr,	गौमुत्र,	गौमूत्र,	
jeevanshaili,	जीवनशाली,	जीवनशैली,	
nagaadaa,	नगाड़ा,	नगाड़ा,	
chhutane,	छुटने,	छूटने,	
bisva,	बिस्वा,	बिस्वा,	
badhit,	बढ़ित,	बाधित,	
kaushalta,	कौशलता,	कौशलता,	
kisanon,	किसनों,	किसानों,	
ukhrul,	उखरुल,	उखरुल,	
karna,	करना,	करना,	
danga,	डांगा,	दंगा,	
pailot,	पैलोट,	पायलट,	
abbott,	एबोटट,	एबोट,	
rasaayanon,	रसायनों,	रसायनों,	
dubana,	दुबना,	डुबाना,	
dak,	डक,	डाक,	
dhndhe,	ढनढे,	धंधे,	
huin,	हुइन,	हुईं,	
longoval,	लोंगोवाल,	लोंगोवाल,	
kaushalata,	कौशलता,	कौशलता,	
napne,	नापने,	नापने,	
fodaa,	फोडा,	फोड़ा,	
chand,	चांड,	चंद,	
cpm,	सीपीएम,	सीपीएम,	
navya,	नव्य,	नव्या,	
rasaayanik,	रासायणिक,	रसायनिक,	
munnu,	मुन्नू,	मुन्नू,	
gangaajal,	गंगाजल,	गंगाजल,	
libration,	लाइब्रेशन,	लिब्रेशन,	
chetti,	चेट्टी,	चेट्टी,	
misha,	मिशा,	मिशा,	
dadrewa,	दद्रेव,	ददरेवा,	
kihatkati,	किहटती,	खटकती,	
taantaa,	टांटा,	तांता,	
daka,	डका,	डाका,	
sachidanand,	सचिदानंद,	सच्चिदानंद,	
prahad,	प्रहाद,	प्रह्लाद,	
bona,	बोना,	बोना,	
paheliyon,	पहेलियों,	पहेलियों,	
ishaaraa,	इशारा,	इशारा,	
chhalla,	छल्ला,	छल्ला,	
capacitor,	कैपेसिटर,	कैपेसिटर,	
vibhajak,	विभाजक,	विभाजक,	
anupryogon,	अनुप्रोगों,	अनुप्रयोगों,	
judai,	जुडाई,	जुड़ाई,	
budvig,	बुद्वीग,	बुडविग,	
kushaan,	कुशान,	कुषाण,	
pravati,	प्रवाती,	प्रवत्ति,	
paraadhin,	पराधीन,	पराधीन,	
chiththi,	चित्ठी,	चिठ्ठी,	
maarvaad,	मारवाद,	मारवाड़,	
vaitrawati,	वैत्रवती,	वैत्रवती,	
lenset,	लेंसेट,	लैंसेट,	
sund,	सुंड,	सूंड़,	
pushkarana,	पुष्करण,	पुष्करणा,	
brahmlin,	ब्रह्म्लीन,	ब्रह्मलीन,	
sakara,	सकरा,	सकरा,	
dhakaal,	ढकाल,	ढकाल,	
ripan,	रिपन,	रिपन,	
jasmeet,	जसमीत,	जसमीत,	
awazon,	आवाजों,	आवाज़ों,	
uplaksh,	उपलक्ष,	उपलक्ष्य,	
bosan,	बोसन,	बोसान,	
thane,	थाने,	थाणे,	
urvarata,	उर्वरता,	उर्वरता,	
testing,	टेस्टिंग,	टेस्टिंग,	
chart,	चर्ट,	चार्ट,	
ounce,	आउंस,	आउंस,	
udane,	उड़ने,	उड़ाने,	
nineteez,	निनेटीज,	नाइनटीज,	
greist,	ग्रेस्ट,	ग्रीस्ट,	
multai,	मुलताई,	मुल्ताई,	
dhakal,	ढकाल,	ढकाल,	
sapne,	सपने,	सपने,	
adhiwas,	अधिवास,	अधिवास,	
pran,	प्राण,	प्राण,	
snikarse,	स्निकर्स,	स्नीकर्स,	
vishhin,	विष्हीन,	विषहीन,	
mood,	मूड,	मूड,	
lime,	लाइम,	लाइम,	
vibha,	विभा,	विभा,	
sugamata,	सुगमता,	सुगमता,	
dayitv,	दयित्व,	दायित्व,	
kanishthikaa,	कनिष्ठिका,	कनिष्ठिका,	
neechaaee,	नीचाई,	नीचाई,	
katthaii,	कट्ठाई,	कत्थई,	
avrutiyon,	अवृतियों,	आवृत्तियों,	
milkiyat,	मिलकियत,	मिल्कियत,	
chhajan,	छजन,	छाजन,	
mitaao,	मिटाओ,	मिटाओ,	
bangsh,	बंगश,	बंगश,	
akhand,	अखंड,	अखंड,	
facial,	फैसियल,	फेशियल,	
lindon,	लिंडन,	लिंडन,	
down,	डाउन,	डाउन,	
kide,	कीडे,	कीड़े,	
chlenge,	च्लेंजे,	चलेंगे,	
shrunkhlaon,	श्रृंखलाओं,	श्रंखलाओं,	
gouchar,	गौचार,	गोचर,	
manchon,	मांचों,	मंचों,	
ank,	अंक,	अंक,	
nitya,	नित्य,	नित्या,	
owem,	ओवम,	ओवम,	
munafa,	मुनाफा,	मुनाफा,	
tiron,	तिरों,	तीरों,	
avuti,	अवुति,	आवृत्ति,	
nuskhe,	नुस्खे,	नुस्खे,	
uthakar,	उठाकर,	उठाकर,	
ladte,	लड़ते,	लड़ते,	
asurakshit,	असुरक्षित,	असुरक्षित,	
khanikarmi,	खानिकर्मी,	खनिकर्म,	
entone,	एंटोन,	एंटोन,	
diwani,	दिवानी,	दिवानी,	
sarjuga,	सरजुगा,	सरगुजा,	
trijata,	त्रिजता,	त्रिजटा,	
neta,	नेता,	नेता,	
pisaai,	पिसाई,	पिसाई,	
mnaey,	मनाए,	मनाए,	
bodara,	बोद्रा,	बोदरा,	
fatane,	फटने,	फटने,	
halchal,	हलचल,	हालचाल,	
pipraa,	पिपरा,	पिपरा,	
networking,	नेटवर्किंग,	नेटवर्किग,	
cheh,	चेह,	छह,	
obrien,	ओब्रीन,	ओब्रायन,	
dhandhaanya,	धानाधान्य,	धनधान्य,	
nidhan,	निधन,	निधान,	
tyoharon,	त्योहारों,	त्यौहारों,	
shaao,	शाओ,	शाओ,	
qasim,	कसीम,	कासिम,	
jalesar,	जलेसर,	जलेसर,	
qawwaliyon,	कववालियों,	कव्वालियों,	
ekaee,	ईकाई,	इकाई,	
virodh,	विरोध,	विरोध,	
brock,	ब्रॉक,	ब्रोक,	
faisla,	फैसला,	फ़ैसला,	
mardani,	मरदानी,	मरदानी,	
taaza,	ताजा,	ताजा,	
andhapan,	अंधापन,	अंधापन,	
dakhil,	दख़िल,	दाखिल,	
bhukh,	भूख,	भूख,	
parwa,	परवा,	परवा,	
lati,	लती,	लाती,	
ginte,	गिनते,	गिनते,	
sabah,	सबाह,	साबाह,	
items,	इटेम्स,	आइटम्स,	
franciska,	फ्रांसिस्क,	फ्रांसिस्का,	
bikherati,	बिखेरती,	बिखेरती,	
anyaya,	अन्याय,	अन्याय,	
nagrik,	नागरिक,	नागारिक,	
rotation,	रोटेशन,	रोटेशन,	
fringe,	फ्राइंज,	फ्रिंज,	
retweet,	रेतवीत,	रीट्वीट,	
gomke,	गोमके,	गोमके,	
goswami,	गोस्वामी,	गोस्वामी,	
maryaadaa,	मर्याा,	मर्यादा,	
jerusalem,	जेरूसलम,	यरूशलेम,	
ashvtth,	अश्वत्थ,	अश्वत्थ,	
nevedya,	नेवेद्य,	नैवेद्य,	
dhale,	ढाले,	ढले,	
brijesh,	बृजेश,	ब्रजेश,	
dhkal,	ढकाल,	ढकाल,	
bahawalpur,	बहवलपुर,	बहावलपुर,	
jagruti,	जागरूति,	जागृति,	
jue,	जुए,	जुए,	
fawaaron,	फवारों,	फव्वारों,	
rasyanik,	रास्यानिक,	रसायनिक,	
simatta,	सिमत्ता,	सिमटता,	
massachusetts,	मैसाचुसेट्स,	मैसाचुसेट्स,	
gaen,	गाएं,	गाएं,	
dangon,	डांगों,	दंगों,	
vartamaan,	वर्तमान,	वर्तमान,	
alphabet,	अल्फाबेट,	अल्फ़ाबेट,	
sanchalnon,	संचालनों,	संचालनों,	
pisai,	पिसाई,	पिसाई,	
alaps,	अलाप्स,	ऐल्प्स,	
sankhyaen,	संख्याएं,	संख्याएं,	
jh,	झे,	झ,	
samalakhaa,	समलखा,	समालखा,	
shamitabh,	शमीताभ,	शमिताभ,	
chhetri,	छेत्री,	छेत्री,	
hadauti,	हडौती,	हाड़ौती,	
anuchit,	अनुच्छित,	अनुचित,	
sunaron,	सुनारों,	सुनारों,	
shat,	शत,	षट्,	
bule,	बुले,	बुले,	
neetiyon,	नीतियों,	नीतियों,	
alankar,	अलंकर,	अलंकार,	
subhaay,	सुभाय,	सुभाय,	
pathykram,	पाठ्यक्रम,	पाठ्यक्रम,	
updravi,	उप्रववी,	उपद्रवी,	
raghupati,	रघुपति,	रघुपति,	
laundry,	लाउंड्री,	लॉन्ड्री,	
sexual,	सेक्सुल,	सेक्सुअल,	
nilaabh,	नीलाभ,	नीलाभ,	
pranit,	प्राणित,	प्रनीत,	
marathi,	मराठी,	मराठी,	
mhanideshak,	महानिदेशक,	महानिदेशक,	
jatatee,	जताती,	जताती,	
africa,	अफ्रीका,	अफ्रीका,	
aawajon,	आवाजों,	आवाज़ों,	
maurya,	मौर्य,	मौर्यों,	
mezbaani,	मेजबानी,	मेज़बानी,	
bharatanatyam,	भारतनाट्माम,	भरतनाट्यम्,	
putin,	पुटिन,	पुतिन,	
pooranpur,	पूरानपुर,	पूरनपुर,	
jarakh,	जराख,	जरख,	
spray,	स्प्राय,	स्प्रे,	
sliders,	स्लाइडर्स,	स्लाइड्स,	
mejbani,	मेजबानी,	मेजबानी,	
galaxyon,	गलक्ष्यों,	गैलेक्सियों,	
chikitsak,	चिकित्सक,	चिकित्सक,	
antah,	अंताह,	अंतः,	
noobiyaa,	नूबिया,	नूबिया,	
nikhari,	निखारी,	निखरी,	
mangani,	मंगानी,	मांगनी,	
pahante,	पहांते,	पहनते,	
banvaa,	बनवा,	बनवा,	
kapdo,	कपड़ो,	कपड़ो,	
november,	नवेंबर,	नवंबर,	
pachaataa,	पचाता,	पचाता,	
kanti,	कांटी,	कांति,	
dhaatuein,	धातुएं,	धातुएं,	
tainin,	टैनिन,	टैनिन,	
hamaal,	हमाल,	हमाल,	
jajmauu,	जजमाऊ,	जाजमऊ,	
adhyayanrat,	अध्ययनरात,	अध्ययनरत,	
pisa,	पीसा,	पीसा,	
kut,	कुट,	कूट,	
jaghaega,	जगाएगा,	जगाएगा,	
baji,	बाजी,	बाज़ी,	
dolane,	डोलने,	डोलने,	
mardon,	मरदों,	मर्दों,	
changed,	चैंगेड,	चेंज्ड,	
jalvaayu,	जलवायु,	जलवायु,	
samjhoonga,	समझूनगा,	समझूंगा,	
kaylana,	कायलाना,	कायलाना,	
jio,	जियो,	जीयो,	
gudna,	गुड़ना,	गुदना,	
sunega,	सुनेगा,	सुनेगा,	
udanen,	उड़नें,	उड़ानें,	
samnvyak,	समन्वयक,	समन्वयक,	
sanjay,	संजाय,	संजय,	
haani,	हानी,	हानी,	
rishte,	रिश्ते,	रिश्ते,	
baksi,	बकसी,	बक्सी,	
nabj,	नब्ज,	नब्ज़,	
pakaude,	पकौड़े,	पकौड़े,	
retreate,	रेट्रीट,	रीट्वीट,	
regional,	रेजिनल,	रीजनल,	
saga,	सगा,	सागा,	
lehrayi,	लहरायी,	लहराई,	
manner,	मैनर,	मैनर,	
ayodhyaanaath,	अयोध्यनाथ,	अयोध्यानाथ,	
jassi,	जस्सी,	जस्सी,	
aakhet,	आखेत,	आखेट,	
aden,	आड़ेन,	एडेन,	
nelson,	नेल्सन,	नेल्सन,	
goel,	गोल,	गोयल,	
parnell,	पर्नेल,	पार्नेल,	
welder,	वेल्डर,	वेल्डर,	
vishahin,	विषाहीन,	विषहीन,	
bairakpur,	बैरकपुर,	बैरकपुर,	
labelon,	लबेलों,	लेबलों,	
mezbaan,	मेजबान,	मेजबान,	
anawashyak,	अनावाश्क,	अनावश्यक,	
karanjiya,	करंजीय,	करंजिया,	
sahakalakar,	सहकालाकार,	सहकलाकार,	
murjha,	मुरझा,	मुर्झा,	
gujarate,	गुजराते,	गुजारते,	
kping,	कीपिंग,	कपिंग,	
nominate,	नॉमिनेट,	नॉमिनेट,	
landara,	लानडारा,	लंगड़ा,	
rantle,	रंतले,	रेंटल,	
dhasmaanaa,	धस्माना,	धस्माना,	
machaye,	मचाए,	मचाए,	
robertsan,	रॉबर्ट्सन,	रॉबर्टसन,	
udharv,	उधारव,	ऊर्ध्व,	
ravish,	रविष,	रविश,	
sukhakar,	सुखाकर,	सूखाकर,	
dhonaa,	ढोना,	धोना,	
raak,	राक,	राक,	
agra,	अग्रा,	अग्र,	
haaranaa,	हराना,	हारना,	
raidical,	रैडिकल,	रैडिकल,	
slide,	स्लाइड,	स्लाइड,	
chheenk,	छीनक,	छींक,	
laingadan,	लैंगड़न,	लैंगडन,	
devnaar,	देवनार,	देवनार,	
lahsun,	लहसून,	लहसुन,	
convention,	कन्वेशन,	कनवेंशन,	
tarashay,	तराशय,	तराशे,	
paneer,	पनीर,	पनीर,	
simtata,	सिमताता,	सिमटता,	
sandhan,	संधन,	संधान,	
methanol,	मैथेनल,	मेथेनॉल,	
nazeem,	नजीम,	नजीम,	
lahlahati,	लहलाहती,	लहलहाती,	
lahanaa,	लहना,	लहना,	
aahnan,	आहानन,	आह्नान,	
vayna,	वायना,	वायना,	
bechkar,	बेचकर,	बेचकर,	
jaat,	जात,	जात,	
dukhon,	दुखों,	दुखों,	
registerd,	रजिस्टर्ड,	रजिस्टर्ड,	
brok,	ब्रोक,	ब्रोक,	
bakaayon,	बकायों,	बकायों,	
han,	हान,	हां,	
bikherti,	बिखेरती,	बिखेरती,	
bangbandhu,	बांगबंदु,	बंगबंधु,	
pendulam,	पेंडुलम,	पेंडुलम,	
liberation,	लाइब्रेशन,	लिबरेशन,	
awantipora,	अवंतिपिरा,	अवंतिपुर,	
chhati,	छाती,	छाती,	
bhusi,	भूसी,	भूसी,	
samprabhu,	संप्रभु,	संप्रभु,	
kasimabad,	कसीमाबाद,	कासिमाबाद,	
nandanvan,	नंदनवन,	नंदनवन,	
suchak,	सुचाक,	सूचक,	
avsthaen,	अवस्थाएं,	अवस्थाएं,	
shirshkon,	शिर्षकों,	शीर्षकों,	
hardas,	हरदास,	हरदास,	
najarandaaz,	नजरअंदाज़,	नजरंदाज,	
avika,	अविका,	अविका,	
pinta,	पिंटा,	पिंटा,	
likhkar,	लिखकर,	लिखकर,	
advaitvaad,	अद्वैत्वाद,	अद्वैतवाद,	
theateron,	ठीटरों,	थियेटरों,	
pagbadha,	पगगबा,	पगबाधा,	
mejbani,	मेजबानी,	मेज़बानी,	
manjil,	मंजिल,	मंजिल,	
kamottejna,	कमोटेटना,	कामोत्तेजना,	
shaniwar,	शानिवार,	शनिवार,	
gerome,	गेरोम,	जेरोम,	
batlaakar,	बतलाकर,	बतलाकर,	
craig,	क्रैज,	क्रेग,	
fyuji,	फ्यूजी,	फ्यूजी,	
lakir,	लाकिर,	लकीर,	
atmaen,	आत्माएं,	आत्माएं,	
janch,	जांच,	जाँच,	
shabana,	शबाना,	शबाना,	
kamatar,	कमातर,	कमतर,	
cavalry,	केवली,	कैवेलरी,	
puru,	पुरु,	पुरू,	
yaariyan,	यारियां,	यारियां,	
swechha,	स्वेछ्छ,	स्वेच्छा,	
makrani,	मकरानी,	मकरानी,	
addi,	अद्दी,	एड्डी,	
dikhaai,	दिखाई,	दिखाईं,	
mavey,	मावे,	मावे,	
likhakar,	लिखाकर,	लिखकर,	
weeks,	विक्स,	वीक्स,	
paramparikta,	परंपरािकता,	पारंपरिकता,	
pahani,	पहानी,	पहनी,	
patiyaa,	पटिया,	पटिया,	
asamaany,	असमान्य,	असमान्य,	
rooting,	रूटिंग,	रूटिंग,	
mejbaan,	मेजबान,	मेज़बान,	
nega,	नेगा,	नेग,	
robertson,	रॉबर्ट्सन,	रॉबर्टसन,	
kriyayog,	क्रियागोग,	क्रियायोग,	
dhoraji,	धोरजी,	धोराजी,	
kusumlata,	कुसुमलता,	कुसुमलता,	
maanga,	मांगा,	मांगा,	
aake,	आके,	आके,	
purvaabhas,	पूर्वाभास,	पूर्वाभास,	
agyaat,	अज्ञात,	अज्ञात,	
dubhashiyon,	दुभाषियों,	दुभाषियों,	
bhara,	भरा,	भरा,	
mahajan,	महाजन,	महाजन,	
sonu,	सोनु,	सोनू,	
sambit,	संबित,	संबित,	
chaturdik,	चतुर्दिक,	चतुर्दिक,	
vivekheen,	विवेखीन,	विवेकहीन,	
chhekein,	छेकें,	छींके,	
las,	लास,	लास्ट,	
unthak,	ऊंथक,	अनथक,	
bagh,	बाघ,	बाग,	
jean,	जीन,	जीन,	
bare,	बारे,	बरे,	
drame,	ड्रेम,	ड्रामे,	
visheshaadhikaar,	विषेषाधिकार,	विशेषाधिकार,	
rahegi,	रहेगी,	रहेगी,	
scanning,	स्केनिंग,	स्कैनिंग,	
chimti,	चिमटी,	चिमटी,	
pathyakram,	पाठ्यक्रम,	पाठ्यक्रम,	
updravon,	उप्रवाों,	उपद्रवों,	
uniyal,	यूनियल,	उनियाल,	
parosane,	परोसने,	परोसने,	
kocchi,	कोची,	कोच्चि,	
yorker,	यॉर्कर,	यॉर्कर,	
maariyo,	मारियो,	मारियो,	
kpada,	कपाड़ा,	कपड़ा,	
matix,	मैटिक्स,	मैट्रिक्स,	
sansthita,	संस्थिता,	संस्थिता,	
bharni,	भरनी,	भरनी,	
yatn,	यत्न,	यत्न,	
veeresh,	वीरेश,	वीरेश,	
ballabh,	बल्लभ,	बल्लभ,	
uthane,	उठाने,	उठने,	
nanhein,	नन्हें,	नन्हें,	
yarooshaleim,	यारूशलें,	यरूशलेम,	
gandh,	गांध,	गंध,	
addon,	अड्डों,	अड्डों,	
lakshya,	लक्ष्य,	लक्ष्य,	
dwaadas,	द्वादस,	द्वादश,	
mauritius,	मॉरीशियस,	मॉरिशस,	
bhaate,	भाते,	भाते,	
pardesi,	परदेसी,	परदेसी,	
khinchakar,	खिंचकर,	खिंचकर,	
shringar,	श्रृंगार,	शृंगार,	
asvabhavik,	अस्वाभाविक,	अस्वभाविक,	
arushi,	अरुषी,	आरुषि,	
canterbari,	कंटरबारी,	कैंटरबरी,	
niyaa,	निया,	निया,	
kamau,	कमाऊ,	कमाऊ,	
pearson,	पर्सन,	पियरसन,	
barahmasi,	बरहमासी,	बारहमासी,	
nilabh,	नीलभ,	नीलाभ,	
khal,	खल,	खाल,	
haive,	हैवे,	हैव,	
chikitsakon,	चिकित्सकों,	चिकित्सकों,	
megapixel,	मेग्पिस्केल,	मेगापिक्सल,	
pigs,	पिग्स,	पिग्स,	
prahaarak,	प्रहारक,	प्रहारक,	
aanand,	आनंद,	आनद,	
aapadaaaen,	आपदाएं,	आपदाएं,	
shirke,	शिर्के,	शिर्के,	
mahkane,	महकाने,	महकने,	
nikalni,	निकलनी,	निकालनी,	
adhyaynrat,	अध्ययनरत,	अध्ययनरत,	
jhuthala,	झुठला,	झुठला,	
tuning,	ट्यूनिंग,	ट्यूनिंग,	
tariko,	तरीको,	तरीको,	
lega,	लेगा,	लेगा,	
raajon,	राजों,	राजों,	
dayitvon,	दययत्वों,	दायित्वों,	
mexico,	मैक्सिको,	मेक्सिको,	
batlaaye,	बतलाए,	बतलाए,	
queens,	क्वींस,	क्वींस,	
sweet,	स्वीट,	स्वीट,	
dahal,	डहाल,	दहल,	
najeeb,	नजीब,	नजीब,	
chalenge,	चलेंगे,	चलेंगे,	
chiththi,	चित्ठी,	चिट्ठी,	
kabren,	कबरें,	कब्रें,	
dabi,	दाबी,	डाबी,	
bung,	बंग,	बंग,	
emil,	एमिल,	एमिल,	
deshkaal,	देशकाल,	देशकाल,	
parleron,	पार्लोरों,	पार्लरों,	
deepn,	डीपन,	दीपन,	
nihlaani,	निहलानी,	निहलानी,	
picture,	पिक्चर,	पिक्चर,	
sanskari,	संस्कारी,	संस्कारी,	
dhamm,	धम्म,	धम्म,	
shud,	शुद,	शुड,	
denevaali,	देनेवाली,	देनेवाली,	
pilepan,	पिलेपन,	पीलेपन,	
usmen,	उसमें,	उसमें,	
sapat,	सपत,	सपाट,	
prashaasanon,	प्रशासनों,	प्रशासनों,	
stops,	स्टॉप्स,	स्टॉप्स,	
macbook,	मैकूम,	मैकबुक,	
bandhuon,	बंंधुओं,	बंधुओं,	
nihalchand,	निहलचंद,	निहालचंद,	
vidhansabhaein,	विभानसभाएं,	विधानसभाएं,	
racer,	रेसर,	रेसर,	
bhukhi,	भूखी,	भूखी,	
andrabi,	अंदराबी,	अंद्राबी,	
processing,	प्रोसेसिंग,	प्रॉसेसिंग,	
naam,	नाम,	नाम,	
heroes,	हिरोस,	हीरोज,	
vatar,	वातर,	वाटर,	
manch,	मांच,	मंच,	
tapan,	तपन,	तपन,	
tuberkyulosis,	टुब्रोलुलोसिस,	ट्यूबरक्यूलोसिस,	
longewal,	लोंगेवाल,	लोंगोवाल,	
jvar,	ज्वर,	ज्वार,	
mukhopadhyaya,	मुखोपाधाध्याय,	मुखोपाध्याय,	
pangolin,	पंगोलिन,	पैंगोलिन,	
janahaani,	जानाहानी,	जनहानि,	
jivan,	जीवन,	जीवन,	
ishaak,	इशाक,	इशाक,	
farrukhnagar,	फर्खुनागार,	फर्रूखनगर,	
uzbek,	उज़्बेक,	उज़्बेक,	
asfalt,	असफल्ट,	एस्फाल्ट,	
banam,	बनाम,	बनाम,	
mum,	मूम,	मम,	
tapoowo,	टपपू,	टापुओं,	
jerusalem,	जेरूसलम,	येरुशलम,	
phalitartha,	फलीतार्थ,	फलितार्थ,	
dabolim,	डबोलिम,	डाबोलिम,	
cant,	कैंट,	कांट,	
daw,	दाव,	दाव,	
dhammaa,	धम्मा,	धम्मा,	
karur,	करूर,	करूर,	
phalata,	फलता,	फलता,	
hairam,	हैराम,	हैरम,	
kardhe,	कर्धे,	करघे,	
kamate,	कमाते,	कमाते,	
kanthhar,	कंठर,	कंठहार,	
lovasa,	लोवसा,	लवासा,	
amaanat,	अमानत,	अमानत,	
straws,	स्ट्रॉस,	स्ट्रास,	
shaasakon,	शासकों,	शासकों,	
kanindham,	कणिन्म,	कनिंघम,	
formuley,	फॉर्मूले,	फार्मूले,	
chink,	चिंक,	छींक,	
samadjiyon,	समदद्जियों,	समाधियों,	
mithaai,	मिठाई,	मिठाई,	
tikone,	टिकोन,	तिकोने,	
mamooli,	ममूली,	मामूली,	
andreas,	एंड्रीयस,	एंड्रियास,	
amy,	अम्य,	एमी,	
palari,	पलारी,	पलारी,	
jatati,	जताती,	जताती,	
packagon,	पककागों,	पैकेजों,	
masaaledaar,	मसालेदार,	मसालेदार,	
dhaak,	ढाक,	धाक,	
ankit,	अंकित,	अंकित,	
aj,	अज,	एजे,	
puna,	पुना,	पुना,	
chhutne,	छुटने,	छूटने,	
shaishav,	शैशाव,	शैशव,	
hindon,	हिंदों,	हिंडन,	
sahuliyat,	सहूलियत,	सहूलियत,	
superhit,	सुपेरहित,	सुपरहिट,	
damale,	दमले,	दामले,	
masaledaar,	मसालेदार,	मसालेदार,	
biggest,	बिग्सेट,	बिगेस्ट,	
ganpati,	गणपती,	गणपति,	
theinga,	ठेंगा,	ठेंगा,	
machaaye,	मचाए,	मचाए,	
vadak,	वादक,	वादक,	
pidiyaa,	पीढ़िया,	पीडिया,	
bhula,	भुला,	भूला,	
wirerless,	वायरलेस,	वायरलेस,	
angadh,	अंगढ़,	अनगढ़,	
madhuara,	मधुरा,	मढ़ौरा,	
boliae,	बोलिए,	बोलिए,	
follow,	फोलो,	फ़ॉलो,	
taaja,	ताजा,	ताजा,	
rangte,	रंगते,	रंगते,	
khattapan,	खट्टापन,	खट्टापन,	
jodo,	जोड़ो,	जोड़ो,	
manjilein,	मंजीलें,	मंजिलें,	
vritton,	वृत्तों,	वृत्तों,	
peg,	पेग,	पेग,	
ninties,	निंटीज,	नाइनटीज,	
janahani,	जानाहीनी,	जनहानि,	
jiya,	जिया,	जिया,	
ghumaan,	घुमान,	घुमाण,	
mhapran,	महाप्रण,	महाप्राण,	
halt,	हाल्ट,	हाल्ट,	
gthalidar,	ग्थालीदार,	गुठलीदार,	
rukavaton,	रुकावटों,	रूकावटों,	
peelepan,	पीलेपन,	पीलेपन,	
lalkarata,	लालकरता,	ललकारता,	
thief,	थीफ,	थीफ,	
velkan,	वेलकन,	वल्कन,	
neco,	नेको,	नेको,	
chandon,	चांदों,	चंदों,	
daakhile,	दाखिले,	दाखिले,	
veronica,	वेरोनिका,	वेरोनिका,	
bhoopsingh,	भूपसिंघ,	भूपसिंह,	
sugmta,	सुगमता,	सुगमता,	
sunaseer,	सुनासिर,	सुनासीर,	
chayal,	चयाल,	चायल,	
spry,	स्प्री,	स्प्रे,	
fatehgadh,	फातेगढ़,	फतेहगढ़,	
gaye,	गाये,	गए,	
dayityon,	दयित्यों,	दायित्वों,	
shao,	शाओ,	शाओ,	
karnataka,	कर्नाटका,	कर्नाटका,	
girti,	गिरती,	गिरती,	
domenic,	डोमेनिक,	डोमेनिक,	
prashasanon,	प्रशासनों,	प्रशासनों,	
rollers,	रॉलर्स,	रोलर्स,	
aster,	एस्टर,	एस्टर,	
lanset,	लांसेट,	लैंसेट,	
orian,	ओरियान,	ओरियन,	
bravo,	ब्रावो,	ब्रावो,	
pharth,	फर्थ,	फर्थ,	
jenee,	जेनी,	जेनी,	
bholi,	भोली,	भोली,	
kankar,	कनकर,	कंकर,	
mang,	मंग,	मांग,	
eksaath,	एक्साथ,	एकसाथ,	
kabron,	कबरों,	कब्रों,	
prahasan,	प्रहासन,	प्रहसन,	
borkar,	बोरकर,	बोरकर,	
gangajal,	गंगाजल,	गंगाजल,	
laigikata,	लाइगिकता,	लैंगिकता,	
ail,	एल,	ऐल,	
chidhte,	चिढ़ते,	चिढ़ते,	
sukhti,	सूखती,	सूखती,	
jajmau,	जजमाऊ,	जाजमऊ,	
singar,	सिंगर,	सिंगार,	
padha,	पढ़ा,	पढ़ा,	
mejban,	मेजबन,	मेजबान,	
bala,	बला,	बाला,	
niki,	निकी,	निकी,	
tankar,	टांकर,	टंकार,	
khaen,	खाएं,	खाएं,	
chhuraa,	छुरा,	छुरा,	
hamal,	हमल,	हमाल,	
chhallaa,	छल्ला,	छल्ला,	
kanyaayen,	कन्याएं,	कन्याएं,	
anuprayogon,	अनुप्रायोगों,	अनुप्रयोगों,	
namdhari,	नामधारी,	नामधारी,	
fikra,	फिक्र,	फिक्र,	
aradas,	अरदास,	अरदास,	
lalkarta,	लालकर्ता,	ललकारता,	
gr,	ग्र,	जीआर,	
rahmat,	रहमत,	रहमत,	
biswa,	बिस्वा,	बिस्वा,	
mahathir,	महाठिर,	महाथिर,	
aavritti,	आवृत्ति,	आवृत्ति,	
survin,	सर्विन,	सुरवीन,	
bhabhut,	भभूत,	भभूत,	
ovum,	ओवम,	ओवम,	
utne,	उतने,	उतने,	
farukhabad,	फरुखाबाद,	फर्रुखाबाद,	
canterbury,	कैंटरबरी,	कैंटरबरी,	
gujar,	गुजर,	गुजार,	
juban,	जुबान,	ज़ुबान,	
karam,	करम,	करम,	
pehnate,	पहनते,	पहनता,	
eddie,	एड्डी,	एड्डी,	
stithi,	स्तिथि,	स्तिथि,	
strokes,	स्ट्रॉक्स,	स्ट्रोक्स,	
vesle,	वेसल,	वेस्ले,	
championship,	चैंपियोपिष,	चैंपियनशिप,	
route,	राउट,	रूट,	
besil,	बेसिल,	बेसिल,	
mahavishnu,	महाविषाणु,	महाविष्णु,	
dampatiyon,	दाम्तियों,	दंपतियों,	
asaamnjsy,	असमंजस्य,	असामंजस्य,	
scooteron,	स्कूटरों,	स्कूटरों,	
mahantam,	महंतम,	महानतम,	
charge,	चार्ज,	चार्ज,	
singhi,	सिंही,	सिंघी,	
lindan,	लिंडन,	लिंडन,	
harem,	हरेम,	हैरम,	
zamaanaa,	ज़माना,	ज़माना,	
jaatkon,	जाटकों,	जातकों,	
dhandhany,	ढानाध्य,	धनधान्य,	
ilayachi,	इलायाछी,	इलाइची,	
chhaviyaan,	छावियां,	छवियाँ,	
chadhne,	चढ़ने,	चढ़ने,	
bhooswaami,	भूस्वामी,	भूस्वामी,	
avishvaasniy,	अविश्वासनीय,	अविश्वसनीय,	
pharmacy,	फरमास्सी,	फार्मेसी,	
ramkote,	रामकोट,	रामकोट,	
reson,	रेसन,	रेसों,	
evening,	एवेनिंग,	ईवनिंग,	
fod,	फॉड,	फोड़,	
laurens,	लॉरेंस,	लौरेंस,	
tantrikaon,	तंत्रिकाओं,	तंत्रिकाओं,	
jamati,	जमती,	जमाती,	
padmavati,	पद्मावती,	पदमावती,	
aagman,	आग्मान,	आगमन,	
tantr,	टंंट्र,	तंत्र,	
zulmon,	जुल्मों,	जुल्मों,	
bevkufana,	बेवकूफना,	बेवकूफाना,	
vyabhichari,	व्याभिचारी,	व्यभिचार,	
daratey,	डरते,	डराते,	
angarak,	अंगारक,	अंगारक,	
oklahoma,	ओक्लाहोमा,	ओकलाहोमा,	
sultana,	सुल्टाना,	सुलताना,	
khinchkar,	खिंचकर,	खींचकर,	
bag,	बाग,	बाग,	
karpatri,	कर्पत्री,	करपात्री,	
nichla,	निचला,	निचला,	
flesh,	फ्लेश,	फ्लेश,	
dikhae,	दिखाए,	दिखार्इ,	
hemvati,	हेमवती,	हेमवती,	
mauryon,	मौर्यों,	मौर्यों,	
sanshyon,	संश्यों,	संशयों,	
ghost,	घोस्ट,	घोस्ट,	
bajana,	बजाना,	बजना,	
dayitva,	दयित्व,	दायित्व,	
shrotaon,	श्रोताओं,	श्रोताओं,	
kagaj,	कागज,	कागज़,	
chhaati,	छाती,	छाती,	
tarashe,	तराशे,	तराशे,	
sankhyaein,	संख्याएं,	संख्याएं,	
kruger,	क्रूगर,	क्रूगर,	
naraji,	नाराजी,	नाराजी,	
bholu,	भोलू,	भोलू,	
ranjkta,	रांजकता,	रंजकता,	
baitool,	बैटुल,	बैतूल,	
sunaaron,	सुनारों,	सुनारों,	
phode,	फोड,	फोड़े,	
aarya,	आर्य,	आर्यो,	
jerome,	जेरोम,	जेरोम,	
kashton,	काष्टों,	कष्टों,	
pages,	पेग्स,	पेजेज,	
jenner,	जेनर,	जेनर,	
jamaati,	जमाती,	जमाती,	
saunpane,	सौंपने,	सौंपने,	
libration,	लाइब्रेशन,	लिबरेशन,	
balla,	बल्ला,	बल्ला,	
swaroopon,	स्वरूपों,	स्वरुपों,	
kalapi,	कलापी,	कालपी,	
beemon,	बीमों,	बीमों,	
dikhaai,	दिखाई,	दिखार्इ,	
pahlaa,	पहला,	पहला,	
talvon,	तलवों,	तलवों,	
maryadaon,	मर्यदाओं,	मर्यादाओं,	
bipin,	बीपीन,	बिपिन,	
bhrantiyon,	भ्रंटियों,	भ्रांतियों,	
naseem,	नसीम,	नसीम,	
haalchaal,	हलचचाल,	हालचाल,	
padrauna,	पद्रौण,	पडरौना,	
shaakir,	शाकिर,	शाकिर,	
dhiryavan,	धिर्यवान,	धैर्यवान,	
shrunkhla,	श्रृंखला,	श्रंखला,	
upakhyaanon,	उपख्यानों,	उपाख्यानों,	
saptapadi,	सप्तापादी,	सप्तपदी,	
alankaaron,	अलंकारों,	अलंकारों,	
agusta,	अगुस्ता,	अगस्ता,	
jerry,	जेरी,	जैरी,	
shringaar,	श्रींगार,	शृंगार,	
ardas,	अरदास,	अरदास,	
daaw,	दाव,	दाव,	
vaangchuk,	वांगचुक,	वांगचुक,	
hamalavar,	हमलावर,	हमलावर,	
dvivedi,	द्विवेदी,	द्विवेदी,	
chehon,	चेहों,	छहों,	
tadipaar,	तादीपार,	तड़ीपार,	
dilaye,	दिलाए,	दिलाये,	
teeron,	टीरों,	तीरों,	
nirdeshika,	निर्देशिका,	निर्देशिका,	
parishadiy,	परिशादीय,	परिषदीय,	
babat,	बबत,	बाबत,	
water,	वेटर,	वाटर,	
basin,	बसीन,	बेसिन,	
yaari,	यारी,	यारी,	
fulaaye,	फुलाए,	फुलाए,	
brajesh,	ब्रजेश,	ब्रजेश,	
zarakh,	जराख,	जरख,	
bolane,	बोलने,	बोलने,	
beejak,	बीजक,	बीजक,	
suriname,	सुरिनाम,	सूरीनाम,	
maariya,	मारिया,	मारिया,	
vije,	विजे,	वाइज,	
egmor,	एग्मोर,	एगमोर,	
rugnata,	रुगनता,	रुग्णता,	
visheshadhikar,	विशेषाधिकार,	विशेषाधिकार,	
mangi,	मंगी,	मांगी,	
jipani,	जिपानी,	जीपनी,	
yarayan,	यारायन,	यात्राएं,	
nazarandaaj,	नजरअंदाज़,	नजरंदाज,	
patakkar,	पटककार,	पटककर,	
vaitravati,	वैत्रवती,	वैत्रवती,	
man,	मान,	मैन,	
karchhana,	कर्चना,	करछना,	
marji,	मर्जी,	मर्जी,	
khuda,	खुदा,	खुदा,	
sphoorti,	स्फूर्ती,	स्फूर्ति,	
kanishthika,	कनिष्ठिक,	कनिष्ठिका,	
girish,	गिरिश,	गिरीश,	
anukulata,	अनुकुलता,	अनुकूलता,	
kamraj,	कमराज,	कामराज,	
mtec,	एमटैक,	एमटेक,	
jhalkati,	झलकती,	झलकती,	
anukoltha,	अनुकोल्ठ,	अनुकूलता,	
piyari,	पियारी,	पियरी,	
bhraanti,	भ्रांति,	भ्रांति,	
shrankhala,	श्रृंखला,	श्रंखला,	
naksalwaad,	नकसलवाद,	नक्सलवाद,	
peetne,	पीटने,	पीटने,	
latkate,	लटकते,	लटकाते,	
usmein,	उसमें,	उसमें,	
select,	सेलेक्ट,	सलेक्ट,	
jheel,	झील,	झील,	
jadet,	जड़ेट,	जड़ित,	
karyrat,	कार्यात,	कार्यरत,	
jiyo,	जियो,	जीयो,	
nischal,	निस्चल,	निश्चल,	
nineties,	नाइनेटिज,	नाइनटीज,	
paranormal,	परणोलमाल,	पैरानॉर्मल,	
baagiyon,	बागियों,	बागियों,	
johnson,	जॉन्सन,	जॉनसन,	
polishing,	पोलिशिंग,	पॉलिशिंग,	
main,	मैन,	मैन,	
profit,	प्रोफिट,	प्रॉफिट,	
maisore,	मैसोर,	मैसोर,	
sacchidanand,	सच्चिदंद,	सच्चिदानंद,	
chheter,	छेतर,	छेत्र,	
ekattha,	एकट्ठा,	इकट्ठा,	
anka,	आंका,	अंक,	
varddhaman,	वर्दमामन,	वर्द्धमान,	
salib,	सलीब,	सलीब,	
jamaeya,	जमाएया,	जमाया,	
dvadash,	द्वदाश,	द्वादश,	
aary,	आर्य,	आर्य,	
girkar,	गिरकर,	गिरकर,	
utpan,	उत्पन,	उत्पन,	
dhtuen,	ध्तुएं,	धातुएं,	
sthoolta,	स्थूलता,	स्थूलता,	
narnari,	नर्नरी,	नरनारी,	
baago,	बागो,	बागो,	
harpal,	हरपाल,	हरपाल,	
gaumutra,	गौमुत्र,	गौमूत्र,	
ravaley,	रावले,	रावले,	
tennis,	टेनिस,	टेनिस,	
chhuptaa,	छुप्टा,	छुपता,	
hurricane,	हररीकेन,	हरिकेन,	
chitthi,	चिट्ठी,	चिठ्ठी,	
chaudahavan,	चौदहावन,	चौदहवां,	
ali,	एली,	अली,	
lahna,	लहना,	लहना,	
nishpaap,	निष्पाप,	निष्पाप,	
leedaron,	लीदारों,	लीडरों,	
sanskritiyon,	संस्कृतियों,	संस्कृतियों,	
besahaaraa,	बेसहारा,	बेसहारा,	
prahlaad,	प्रहलाद,	प्रहलाद,	
vidhansabhaen,	विभानसभाएं,	विधानसभाएं,	
barahsinga,	बारहसीनगा,	बारहसिंगा,	
banbi,	बांबी,	बांबी,	
mukhyamantri,	मुख्यमंत्री,	मुख्यमंत्री,	
prardashan,	प्रदर्शन,	प्रर्दशन,	
bagiyon,	बागियों,	बागियों,	
bhariy,	भरीय,	भारीय,	
hisham,	हिशम,	हिशाम,	
paakhandi,	पाखंडी,	पाखंडी,	
dhundhta,	ढूंढता,	ढूंढता,	
tejaji,	तेजजी,	तेजाजी,	
nazraane,	नज़राने,	नजराने,	
aesthetics,	एस्थेटिक्ट्स,	एस्थेटिक,	
labdh,	लब्ध,	लब्ध,	
anurit,	अनुरित,	अनुरीत,	
brigton,	ब्राइटन,	ब्रिगटन,	
sambhalane,	संभालने,	संभालने,	
karoor,	करूर,	करूर,	
panchang,	पंचांग,	पंचांग,	
fransiska,	फ्रांसिक्स,	फ्रांसिस्का,	
poojaapaath,	पूजापाथ,	पूजापाठ,	
nigar,	निगर,	निगर,	
bangash,	बंगाश,	बंगश,	
maisor,	मैसोर,	मैसोर,	
rehana,	रहना,	रेहाना,	
ritual,	रितुआल,	रिचुअल,	
dipsingh,	दिपसिंह,	दीपसिंह,	
chimati,	चिमटी,	चिमटी,	
galaxiyon,	गलक्सियों,	गैलेक्सियों,	
favvare,	फववारे,	फव्वारे,	
generic,	जेनेरिक,	जेनरिक,	
chabutre,	चबूत्रे,	चबूतरे,	
pratishat,	प्रतिषाट,	प्रतिशत,	
samadhiyon,	समाधियों,	समाधियों,	
ghunsa,	घुंसा,	घूंसा,	
kalpanaon,	कल्पनाओं,	कल्पनाओं,	
jvaron,	ज्वरों,	ज्वारों,	
chhetter,	छेत्टर,	छेत्र,	
dhunaai,	धुनाई,	धुनाई,	
rp,	आरपी,	आरपी,	
stone,	स्टोन,	स्टोन,	
duke,	डूके,	ड्यूक,	
dual,	डुएल,	ड्युअल,	
chhetthari,	छेत्ठारी,	छेत्री,	
janajagran,	जनजारग्न,	जनजागरण,	
shield,	शिल्ड,	सील्ड,	
vimarsh,	विमर्श,	विमर्श,	
brigadier,	ब्रिगेडर,	ब्रिगेडियर,	
jarda,	जर्दा,	जर्दा,	
polymer,	पॉलीयर,	पॉलिमर,	
sthool,	स्थूल,	स्थूल,	
hoaf,	हॉफ,	हॉफ,	
then,	ठें,	थेन,	
naksaliyon,	नकसालियों,	नक्सलियों,	
sawaal,	सवाल,	सवाल,	
slides,	स्लाइड्स,	स्लाइड्स,	
fatma,	फत्मा,	फातमा,	
pravatti,	प्रवत्ती,	प्रवत्ति,	
jaiban,	जैबन,	जयबाण,	
varnit,	वर्णीत,	वर्णित,	
siwan,	सिवन,	सिवान,	
dhandhe,	ढांढे,	धंधे,	
sargi,	सरगी,	सरगी,	
ravle,	रावले,	रावले,	
navdha,	नवधा,	नवधा,	
bhurbhura,	भूरभुर,	भुरभुरा,	
bhabhoot,	भभूत,	भभूत,	
tahakhana,	तहखाना,	तहखाना,	
mimicry,	मिमिक्री,	मिमिक्री,	
inhalation,	इंहलेशन,	इनहेलेशन,	
fislaa,	फिसला,	फिसला,	
nanak,	नानक,	नानक,	
talabgaar,	तलबबार,	तलबगार,	
ashrvatath,	अश्वराथाथ,	अश्वत्थ,	
padhaataa,	पढ़ता,	पढ़ाता,	
fusion,	फसिशन,	फ्यूजन,	
vadiyon,	वादियों,	वादियों,	
aagaa,	आगा,	आग़ा,	
sandali,	संदली,	संदली,	
media,	मेडिया,	मिडिया,	
tikamgarh,	तिकमगढ़,	टीकमगढ़,	
gayatri,	गायत्री,	गायत्री,	
refaeli,	रेफाली,	रेफेली,	
sathsath,	सथसथ,	साथसाथ,	
gangrel,	गैंग्रेल,	गंगरेल,	
dhak,	ढक,	धाक,	
bajaru,	बाजरू,	बाजारू,	
jobs,	जॉब्स,	जॉब्स,	
friendship,	फ्रेंडशिप,	फ्रेंडशिप,	
conjunction,	कंजुक्शन,	कंजंक्शन,	
tiwari,	तिवाड़ी,	तिवारी,	
nishchal,	निश्चल,	निश्चल,	
ikai,	ईकाई,	इकाई,	
ginee,	गिनी,	जिनी,	
awaazon,	आवाजों,	आवाज़ों,	
coldvel,	कोडवेल,	काल्डवेल,	
nau,	नौ,	नाऊ,	
blosam,	ब्लोसम,	ब्लॉसम,	
phalne,	फलने,	फलने,	
rajnitikaran,	राजनीतिकरण,	राजनीतीकरण,	
tranjister,	ट्रांजिस्टर,	ट्रांजिस्टर,	
theni,	ठेनी,	थेनी,	
liger,	लाइगर,	लिगर,	
gaanthe,	गांथे,	गांठे,	
kile,	कीले,	क़िले,	
rasayanik,	रासायनिक,	रासायनिक,	
eyarave,	एयरवे,	एयरवे,	
ikattha,	इकट्ठा,	इकट्ठा,	
avasthaayen,	अवस्थाएं,	अवस्थाएं,	
chatgaon,	चटगांव,	चटगांव,	
weronika,	वेरोनिका,	वेरोनिका,	
anakon,	अनकों,	अंकों,	
mezabani,	मेजबानी,	मेजबानी,	
banaam,	बनाम,	बनाम,	
busy,	बसी,	बिजी,	
awazen,	आवाजें,	आवाज़ें,	
packageon,	पैकाजन,	पैकेजों,	
jagayega,	जगाएगा,	जगाएगा,	
bhate,	भाते,	भाते,	
clerys,	क्लेर्स,	क्लेरिस,	
unatees,	यूनाटीस,	उनतीस,	
achnera,	अचननारा,	अछनेरा,	
eddy,	एडी,	एड्डी,	
tadipar,	तादीपार,	तड़ीपार,	
arthon,	अर्थों,	अर्थों,	
praroop,	प्राूप,	प्रारूप,	
baku,	बाकू,	बाकू,	
pihani,	पीहानी,	पिहानी,	
bhabar,	भाबर,	भाबर,	
surinama,	सुरिनामा,	सूरीनाम,	
lairi,	लैरी,	लैरी,	
lahlahaati,	लहलाहाटी,	लहलहाती,	
kusumalataa,	कुसुमालता,	कुसुमलता,	
sapramaan,	सप्रमाण,	सप्रमाण,	
sabhaen,	सभाएं,	सभाएं,	
jat,	जाट,	जात,	
tapti,	तप्ती,	ताप्ती,	
ret,	रेट,	रेत,	
mass,	मैस,	मास,	
bhooli,	भूली,	भूली,	
prem,	प्रेम,	प्रेम,	
aaraam,	आराम,	आराम,	
teer,	टीर,	तीर,	
mahanatam,	महानतम,	महानतम,	
premi,	प्रेमी,	प्रेमी,	
haarjeet,	हरजीत,	हारजीत,	
jalagati,	जलागती,	जलगति,	
vrutton,	वृत्तों,	वृत्तों,	
tuberculosis,	टुब्रोकोलासिस,	ट्यूबरक्यूलोसिस,	
naivedh,	नैवेध,	नैवेद्य,	
jaankaaron,	जानकारों,	जानकारों,	
melani,	मेलानी,	मेलानी,	
alankaar,	अलंकार,	अलंकार,	
tremasik,	ट्रेमासिक,	त्रैमासिक,	
scandinavia,	स्कैंडिनाविया,	स्कैंडिनेविया,	
rehaana,	रहाना,	रेहाना,	
baini,	बैनी,	बैनी,	
sujhaati,	सुझाती,	सुझाती,	
sate,	साते,	सते,	
pataraani,	पतरानी,	पटरानी,	
dhokebaz,	धोकेबाज,	धोखेबाज,	
adhivas,	अधिवास,	अधिवास,	
pushpit,	पुष्पित,	पुष्पित,	
pharse,	फार्स,	फरसे,	
advait,	अद्वैत,	अद्वैत,	
motive,	मोटिव,	मोटिव,	
manchiy,	मांचीय,	मंचीय,	
bazi,	बाजी,	बाज़ी,	
rigal,	रिगल,	रीगल,	
najibabaad,	नजीबबाबाद,	नजीबाबाद,	
bahulya,	बहुल्य,	बाहुल्य,	
jhuthlane,	झुठलाने,	झुठलाने,	
granite,	ग्रेनाइट,	ग्रेनाइट,	
cement,	सैमेंट,	सिमटे,	
prekshakon,	प्रेक्षकों,	प्रेक्षकों,	
pyade,	प्याड,	प्यादे,	
emile,	एमिले,	एमिल,	
mahakane,	महकाने,	महकने,	
lakshy,	लक्ष्य,	लक्ष्य,	
hui,	हुई,	हुईं,	
fatehgarh,	फतहेगढ़,	फतेहगढ़,	
simmy,	सिमी,	सिमी,	
chhootane,	छूटने,	छूटने,	
nrutyon,	नृत्यों,	नृत्यों,	
sarka,	सरका,	सरका,	
trebal,	ट्रेबल,	ट्रेबल,	
dune,	दूने,	दूने,	
ibiza,	इबीजा,	इबीजा,	
vincent,	विंसेंट,	विंसेंट,	
racing,	रेसिंग,	रेसिंग,	
hupper,	हपर,	हूपर,	
convention,	कन्वेशन,	कन्वेंशन,	
save,	सावे,	सेव,	
tharti,	थरती,	थर्टी,	
chhai,	छाई,	छै,	
cup,	कूप,	कप,	
gic,	जीईसी,	जीआईसी,	
race,	रेस,	रेस,	
talawon,	तलावों,	तलवों,	
bhraant,	भ्रांत,	भ्रांत,	
handiya,	हंदिया,	हंडिया,	
hawamahal,	हवमहाल,	हवामहल,	
reza,	रेजा,	रेजा,	
darate,	डरते,	डराते,	
branti,	ब्रांटी,	भ्रांति,	
sochane,	सोचने,	सोचने,	
juye,	जुए,	जुए,	
khairati,	खैरती,	खैराती,	
creg,	क्रेज,	क्रेग,	
broken,	ब्रॉकन,	ब्रोकन,	
yuddhrat,	युद्धारत,	युद्धरत,	
karykartaaon,	कार्यकर्ताओं,	कार्यकर्ताओं,	
eon,	ईयोन,	इआन,	
jeen,	जीन,	जीन,	
aamdi,	आमदी,	आमदी,	
veerchand,	वीरचंद,	वीरचंद,	
tapmano,	तप्मानों,	तापमानों,	
chhetthri,	छेत्त्री,	छेत्री,	
rasad,	रसाद,	रसद,	
surana,	सुराना,	सुराणा,	
rihana,	रिहाना,	रिहाना,	
daav,	दाव,	दाव,	
karta,	करता,	कटरा,	
nicki,	निकी,	निकी,	
shirshakon,	शिर्षकों,	शीर्षकों,	
bhrant,	भ्रांत,	भ्रांत,	
offers,	आफर्स,	ऑफर्स,	
saima,	सैमा,	साइमा,	
parikshaen,	परीक्षाएं,	परीक्षाएं,	
sakra,	सक्र,	सकरा,	
shahdara,	शहदारा,	शहादरा,	
thumari,	थुमरी,	ठुमरी,	
very,	वेरी,	वैरी,	
sat,	सात,	सत,	
dhunai,	धुनाई,	धुनाई,	
scootaron,	स्कूटरों,	स्कूटरों,	
ishaara,	इशारा,	इशारा,	
ashaktataa,	अशकताता,	अशक्तता,	
kalika,	कालिका,	कालिका,	
jivanshaili,	जीवनशाली,	जीवनशैली,	
self,	सेल्फ,	सेल्फ,	
atthas,	अत्थास,	अट्टहास,	
athak,	आथक,	अथक,	
boriwali,	बोरीवाली,	बोरीवली,	
tufail,	ट्यूफेल,	तुफैल,	
sim,	सिम,	सीम,	
melaghaat,	मेलाघाट,	मेलघाट,	
gm,	जीएम,	जीएम,	
sulati,	सुलाती,	सुलाती,	
aparivartanshil,	अपरिवर्तनशील,	अपरिवर्तनशील,	
mahalon,	महालों,	महलों,	
parimal,	परिमाल,	परिमल,	
asmanye,	असमान्य,	असमान्य,	
raakhe,	राखे,	राखे,	
heeraganj,	हीरागंज,	हीरागंज,	
aise,	एसे,	ऐसे,	
shaasaka,	शासका,	शासक,	
chhabi,	छाबी,	छबि,	
roopesh,	रूपेश,	रुपेश,	
badh,	बढ़,	बाध,	
adwait,	अद्वैत,	अद्वैत,	
murmur,	मुरमूर,	मरमर,	
pradhyapakon,	प्राध्यापकों,	प्राध्यापकों,	
belacha,	बेलचा,	बेलचा,	
kaping,	कपपिंग,	कपिंग,	
pilot,	पिलोट,	पायलट,	
vlad,	व्लाड,	व्लाद,	
maine,	मैने,	मैने,	
barrackpore,	बैराकपोर,	बैरकपुर,	
sanskrutiyon,	संस्कृतियों,	संस्कृतियों,	
mundwa,	मुंडवा,	मुंडवा,	
bandhate,	बांधाते,	बांधते,	
sipahi,	सिपाही,	सिपाही,	
chakshu,	चक्शु,	चक्षु,	
theateron,	ठीटरों,	थिएटरों,	
karyakartaon,	कार्यकार्ताओं,	कार्यकर्ताओं,	
punjab,	पुंजब,	पंजाब,	
chhink,	छीनक,	छींक,	
girijagharon,	गिरिजाघरों,	गिरजाघरों,	
prapaaton,	प्रपातों,	प्रपातों,	
falne,	फानने,	फलने,	
aaryan,	आर्यान,	आर्यों,	
rodrigo,	रोड्राइग,	रोड्रिगो,	
parikshaayein,	परीक्षाएं,	परीक्षाएं,	
tau,	ताऊ,	टाऊ,	
sendha,	सेंधा,	सेंधा,	
kapdon,	कपड़ों,	कपड़ो,	
pakshpat,	पक्षपत,	पक्षपात,	
welding,	वेल्डिंग,	वेल्डिंग,	
betul,	बेटुल,	बैतूल,	
sipah,	सिपाह,	सिपाह,	
denevali,	देनेवाली,	देनेवाली,	
abbott,	एबोटट,	एबट,	
chhupkar,	छुपकर,	छुपकर,	
gammat,	गम्मत,	गम्मत,	
sivan,	सिवन,	सिवान,	
ryan,	र्यान,	रयान,	
jiwan,	जीवन,	जीवन,	
nichala,	निचला,	निचला,	
warrior,	वैरियर,	वारियर्स,	
pulse,	पुलसे,	पल्स,	
tugalki,	तुगलकी,	तुगलकी,	
pmch,	पीचच,	पीएमसीएच,	
safety,	सेफ्टी,	सेफ्टी,	
mega,	मेगा,	मेगा,	
khaatey,	खाते,	खाते,	
vytit,	व्यतित,	व्यतीत,	
julus,	जुलूस,	जूलूस,	
praathmikata,	प्राथमिकता,	प्राथमिकता,	
tyred,	टायर,	टायर्ड,	
aavrittiyon,	आवृत्तियों,	आवृत्तियों,	
pathyakramon,	पाठ्यक्रमों,	पाठ्यक्रमों,	
antmurkh,	अंतरमुख,	अंतर्मुख,	
rajinama,	राजिनामा,	राजीनामा,	
siyasi,	सियासी,	सियासी,	
moolar,	मूलर,	मूलर,	
satvat,	सत्वत,	सत्वत,	
maidi,	मैदी,	मैडी,	
niptaaraa,	निपटारा,	निपटारा,	
bouni,	बौनी,	बौनी,	
sutli,	सूतली,	सुतली,	
samanjasy,	समाजजस्य,	सामंजस्य,	
karyabhar,	कार्यभार,	कार्यभार,	
apariharya,	अपरिहार्य,	अपरिहार्य,	
watson,	वास्सन,	वाटसन,	
deeya,	दीय,	दीया,	
yojanaen,	योजनाएं,	योजनाएं,	
nagaaraa,	नगारा,	नगाड़ा,	
jetha,	जेठा,	जेठा,	
soy,	सोय,	सोय,	
agsta,	अगस्ता,	अगस्ता,	
wedding,	वेडिंग,	वेडिंग,	
chidchidapan,	चिड़चिड़ापन,	चिडचिडापन,	
nrityashaili,	नृत्यशाली,	नृत्यशैली,	
niyantaa,	नियंता,	नियंता,	
kalika,	कालिका,	कलिका,	
palatne,	पलातने,	पलटने,	
dipan,	दीपन,	दीपन,	
judai,	जुडाई,	जुदाई,	
lace,	लेस,	लैस,	
surinaam,	सुरीनाम,	सूरीनाम,	
marvad,	मारवाड़,	मारवाड़,	
khariya,	खरिया,	खरिया,	
kaushal,	कौशल,	कौशल,	
asian,	एशियां,	एशियन,	
aulakh,	औलाख,	औलख,	
kuposhit,	कुपोषित,	कुपोषित,	
packajon,	पक्काजों,	पैकेजों,	
tel,	टेल,	तेल,	
mejbaan,	मेजबान,	मेजबान,	
mufalisi,	मुफलीसी,	मुफलिसी,	
apriyary,	अप्रियरी,	अपरिहार्य,	
harpaal,	हरपाल,	हरपाल,	
paathyakram,	पाठ्यक्रम,	पाठ्यक्रम,	
eddi,	एड्डी,	एड्डी,	
bantane,	बांटने,	बंटने,	
dayitwa,	दययत्व,	दायित्व,	
achievement,	अचीवेमेंट,	अचीवमेंट,	
dukhiyon,	दुखियों,	दुखियों,	
aadan,	आदन,	आदान,	
jaawar,	जावर,	जावर,	
ragon,	रगों,	रागों,	
supachy,	सुपच्च्य,	सुपाच्य,	
erika,	एरिका,	एरिका,	
time,	टाईम,	टाइम,	
khushiyan,	खुश्यियां,	खुशियां,	
eliminator,	एलिमाइनेटर,	एलिमिनेटर,	
panama,	पनामा,	पनामा,	
pulam,	पुलम,	पुलम,	
ikarion,	इकारियों,	इकाईयों,	
pujapath,	पुजापथ,	पूजापाठ,	
neet,	नीत,	नीट,	
consultant,	कंसलटांट,	कंसलटेंट,	
modules,	मॉडल्स,	मॉड्यूल्स,	
yari,	यारी,	यारी,	
tahkhana,	तहखाना,	तहखाना,	
akhil,	अखिल,	अखिल,	
jaagriti,	जागरिति,	जागृति,	
paheliyan,	पहेलियां,	पहेलियां,	
napane,	नापने,	नापने,	
sheling,	शेलिंग,	शेलिंग,	
warriors,	वारियर्स,	वारियर्स,	
jaden,	जड़ें,	जड़ें,	
machanon,	मचानों,	मचानों,	
stan,	स्टन,	स्टैन,	
tivoli,	तिवोली,	टिवोली,	
ganapati,	गणपती,	गणपति,	
prastavon,	प्रस्तावों,	प्रस्तावों,	
ria,	रिया,	रिया,	
dhamkaataa,	धमकाता,	धमकाता,	
samoa,	समो,	सामोआ,	
last,	लास्ट,	लास्ट,	
hymen,	हाइमन,	हाइमन,	
westing,	वेस्टिंग,	वेस्टिंग,	
yashpaal,	यशपाल,	यशपाल,	
sinha,	सिन्हा,	सिंहा,	
nihalaani,	निहलानी,	निहलानी,	
aabru,	आब्रू,	आबरू,	
gujarna,	गुजरना,	गुजारना,	
polish,	पोलिश,	पोलिश,	
sarkaaron,	सरकारों,	सरकारों,	
rishikul,	ऋषिकुल,	ऋषिकुल,	
khudai,	खुदाई,	खुदाई,	
nabz,	नब्ब,	नब्ज़,	
longewala,	लोंगेवाला,	लोंगोवाल,	
bachati,	बचाती,	बचती,	
chandan,	चांदन,	चंदन,	
bull,	बुल,	बुल,	
sandarbh,	संदर्भ,	संदर्भ,	
zee,	जी,	ज़ी,	
jajamau,	जजमाऊ,	जाजमऊ,	
udana,	उड़ना,	उड़ाना,	
farukhnagar,	फरुखनागर,	फर्रूखनगर,	
borivali,	बोरीवाली,	बोरीवली,	
nori,	नोरी,	नोरी,	
richual,	रिचुल,	रिचुअल,	
barpaya,	बर्पाया,	बरपाया,	
hoshangabaad,	होशनगाबाद,	होशंगाबाद,	
sarahi,	सराही,	सराही,	
shrart,	शरारत,	शरारत,	
mardanagi,	मर्दानगी,	मर्दानगी,	
junoon,	जुनूं,	जुनून,	
opel,	ओपल,	ओपेल,	
lebalon,	लेबलों,	लेबलों,	
sims,	सिम्स,	सिम्स,	
jivaniya,	जीवनिया,	जीवनियां,	
gazi,	गाज़ी,	गाज़ी,	
bhusvami,	भूस्वामी,	भूस्वामी,	
dampattiyon,	दम्पत्तियों,	दंपतियों,	
advaitwad,	अद्वैत्वाद,	अद्वैतवाद,	
vikramjeet,	विक्रमजीत,	विक्रमजीत,	
niveshakartaa,	निवेषाकरता,	निवेशकर्ता,	
mardaani,	मरदानी,	मरदानी,	
tarkon,	तरकों,	तर्कों,	
simat,	सीमत,	सिमट,	
dhundh,	ढूंध,	ढूंढ,	
jayadayal,	जयदायाल,	जयदयाल,	
physician,	फिजिसियन,	फिजिशियन,	
aakaash,	आकाश,	आकाश,	
upadravi,	उपद्रवी,	उपद्रवी,	
munshiganj,	मुनशींगज,	मुंशीगंज,	
wanshwad,	वंशवाद,	वंशवाद,	
pantar,	पंतर,	पंटर,	
chaplusi,	चपलसूसी,	चापलूसी,	
jnhaani,	जनाहानी,	जनहानि,	
furti,	फुर्ती,	फूर्ति,	
cricket,	क्रिकेट,	क्रिकेट,	
mange,	मंगे,	मांगे,	
shabdarth,	शब्दर्थ,	शब्दार्थ,	
ghodi,	घोड़ी,	घोड़ी,	
stop,	स्टोप,	स्टॉप,	
pushkin,	पुष्किन,	पुश्किन,	
aagah,	आगाह,	आग़ा,	
contemporary,	कंटेपरोरी,	कंटेम्पररी,	
chandu,	चांडू,	चंदू,	
pammu,	पाम्मू,	पम्मी,	
nokri,	नोकरी,	नोकरी,	
prativaad,	प्रतिवाद,	प्रतिवाद,	
updravion,	उप्रवर्यों,	उपद्रवियों,	
vimarshon,	विमर्शों,	विमर्शों,	
parshad,	परशाद,	पार्षद,	
bharte,	भर्ते,	भरते,	
arbab,	अरबब,	अरबाब,	
atwal,	अत्वल,	अटवाल,	
dikhaee,	दिखाई,	दिखाईं,	
chenkein,	चेंके,	छींके,	
kavvali,	कववाली,	कव्वाली,	
avishvasniya,	अविश्वस्नीय,	अविश्वसनीय,	
padmawati,	पद्मावती,	पदमावती,	
jaatiyon,	जातियों,	जातियों,	
sachhidanand,	सचिचादंद,	सच्चिदानंद,	
pagabadha,	पगगबा,	पगबाधा,	
nikalogi,	निकालोगी,	निकलेगी,	
bavra,	बावरा,	बावरा,	
juloos,	जूलूस,	जूलूस,	
lemon,	लेमोन,	लेमन,	
sabhayen,	सभाएं,	सभाएं,	
parda,	परदा,	पर्दा,	
abhi,	अभी,	अभी,	
raj,	रज,	राज,	
achivement,	अचिवेमंट,	अचीवमेंट,	
stan,	स्टन,	स्तन,	
zubair,	जुबैर,	जुबेर,	
ilaichi,	इलाईची,	इलाइची,	
granthiyon,	गृंथियों,	ग्रंथियों,	
ferth,	फर्थ,	फर्थ,	
agyat,	अज्ञात,	अज्ञात,	
kiliyan,	किलियां,	किलियन,	
swachalit,	स्वचालित,	स्वाचालित,	
maxico,	मैक्सिको,	मेक्सिको,	
achanbha,	अचंभा,	अचंभा,	
susanskrut,	सुसंस्कृत,	सुसंस्कृत,	
morya,	मोर्या,	मौर्या,	
darp,	डर्प,	दर्प,	
agashe,	अग्शे,	आगाशे,	
clay,	क्ले,	क्ले,	
alha,	अल्हा,	आल्हा,	
piky,	पिकी,	पिकी,	
vidyaen,	विद्याएं,	विद्याएं,	
pakaen,	पकाएं,	पकाएं,	
avrodhak,	अवरोधक,	अवरोधक,	
mohim,	मोहिम,	मोहिम,	
ebt,	एबीटी,	एबट,	
aaram,	आरम,	आराम,	
gajra,	गाजरा,	गजरा,	
falibhut,	फलीभूत,	फलीभूत,	
greg,	ग्रेज,	ग्रेग,	
khaskar,	खस्कर,	ख़ासकर,	
vasearche,	वरेसरच,	वर्साचे,	
arabab,	अरबब,	अरबाब,	
sirpur,	सिरपुर,	सिरपुर,	
prastaavon,	प्रस्तावों,	प्रस्तावों,	
uchhalane,	उछलने,	उछालने,	
vaimanya,	वैमान्य,	वैमनस्य,	
dabholkar,	दभोलकर,	दाभोलकर,	
vajood,	वाजूद,	वजूद,	
alonso,	एलॉंस,	अलोंसो,	
anishwarwadi,	अनिश्वारवादी,	अनीश्वरवादी,	
ghataayaa,	घटाया,	घटाया,	
chrom,	क्रोम,	क्रोम,	
isaaiyon,	ईसाईयों,	ईसाइयों,	
namavaliyon,	नमावलियों,	नामावलियों,	
sanyojan,	संयोजन,	संयोजन,	
babt,	बबत,	बाबत,	
julmon,	जुल्मों,	जुल्मों,	
sharmana,	शर्मना,	शर्माना,	
meharaam,	मेहराम,	मेहराम,	
tantron,	टंंत्रों,	तंत्रों,	
matpatron,	मातपार्ं,	मतपत्रों,	
uthaakar,	उठाकर,	उठाकर,	
janhaani,	जानहानी,	जनहानि,	
vashikaran,	वाष्ीीकरण,	वशीकरण,	
sapraman,	सप्रमण,	सप्रमाण,	
vladimir,	व्लादीमिर,	व्लादिमीर,	
sanskrutiyan,	संस्कृतियां,	संस्कृतियां,	
bhanu,	भानु,	भानू,	
dita,	दीता,	दिता,	
tansen,	टनसेन,	तानसेन,	
joki,	जोकी,	जोकि,	
vanshvad,	वंशवाद,	वंशवाद,	
parnel,	पर्नेल,	पार्नेल,	
khoikhoi,	खोखोई,	खोईखोई,	
shubhankar,	शुभंकर,	शुभंकर,	
naram,	नरम,	नरम,	
thirke,	थिरके,	थिरके,	
kahne,	कहने,	कहने,	
doge,	डोग,	दोगे,	
subhay,	सुभाय,	सुभाय,	
kundaliya,	कुंडलिया,	कुंडलियाँ,	
lenevali,	लेनेवाली,	लेनेवाली,	
parikhaen,	परिखाएं,	परीक्षाएं,	
label,	लेबल,	लेबल,	
adani,	अदनी,	अदाणी,	
nana,	नाना,	नना,	
bahroopiya,	बहरूपीय,	बहरूपिया,	
icc,	आईसीसी,	आइसीसी,	
bandej,	बंदेज,	बैंडेज,	
lingbhed,	लिंगभेड़,	लिंगभेद,	
kathai,	कथाई,	कत्थई,	
shrabon,	श्रबों,	शराबों,	
generate,	जनरेट,	जेनरेट,	
prashasnik,	प्रशासनिक,	प्रशासनिक,	
root,	रुट,	रूट,	
jitod,	जीतोड़,	जीतोड़,	
tanish,	तननिश,	टैनिस,	
tahkhaana,	तहखाना,	तहखाना,	
angreji,	अग्रेजजी,	अंग्रज़ी,	
hamla,	हमला,	हमला,	
pakaayein,	पकाएं,	पकाएं,	
maid,	मैद,	मैड,	
antarmukh,	अंतरमुख,	अंतर्मुख,	
elaaj,	एलाज,	इलाज,	
rangate,	रंगते,	रंगते,	
theatron,	ठीटरों,	थिएटरों,	
pick,	पिक,	पिक,	
patakshep,	पत्केष्प,	पटाक्षेप,	
theharne,	ठहराने,	ठहरने,	
slice,	स्लाइस,	स्लाइस,	
kanji,	कांजी,	कांजी,	
chatushkoniya,	चतुष्कानिय,	चतुष्कोणीय,	
junun,	जुनु,	जुनून,	
ghongha,	घोंघा,	घोंघा,	
jaatakon,	जाटकों,	जातकों,	
vardhman,	वर्धमान,	वर्द्धमान,	
rahamat,	रहमत,	रहमत,	
charchaon,	चर्चाओं,	चर्चाओं,	
naxalwaad,	नक्लवाद,	नक्सलवाद,	
patkathaayein,	पटकथाएं,	पटकथाएं,	
farth,	फर्थ,	फर्थ,	
dravani,	द्रवानी,	डरावनी,	
sanchari,	संचारी,	संचारी,	
rudolf,	रूडोल्फ,	रुडोल्फ,	
modern,	मॉडर्न,	मॉडर्न,	
prema,	प्रेमा,	प्रेमा,	
vadli,	वादली,	वडाली,	
bahuchara,	बहुचारा,	बहुचरा,	
jununi,	जुनुनी,	जुनूनी,	
okalahoma,	ओकालहोमा,	ओकलाहोमा,	
association,	एसोसियेशन,	एसोसिएशन,	
ghisai,	घिसाई,	घिसाई,	
dhaga,	धागा,	धागा,	
arya,	आर्य,	आर्यो,	
aazmaanaa,	आजमाना,	आजमाना,	
mithila,	मिथिला,	मिथिला,	
ubal,	उबल,	उबाल,	
mahamantra,	महामांत्र,	महामंत्र,	
suja,	सूजा,	सूजा,	
raktaabh,	रक्ताभ,	रक्ताभ,	
bella,	बेल्ला,	बैला,	
aatmayen,	आत्माएं,	आत्माएं,	
megapixal,	मेगापिक्सल,	मेगापिक्सल,	
prathamik,	प्राथमिक,	प्राथमिक,	
selfie,	सेल्फी,	सेल्फी,	
oran,	ओरान,	ओरण,	
nikalani,	निकलानी,	निकालनी,	
deshkal,	देशकाल,	देशकाल,	
basil,	बसील,	बेसिल,	
chupaty,	चुपत्य,	चौपाटी,	
besahara,	बेसहरा,	बेसहारा,	
suljaayi,	सुलजाई,	सुलझाई,	
udaane,	उड़ने,	उड़ाने,	
dhoondhi,	धूंधी,	ढूंढी,	
purple,	पुर्पल,	पर्पल,	
amaanati,	अमानती,	अमानती,	
sarkaron,	सरकारों,	सरकारों,	
laata,	लाटा,	लाता,	
ikaiyon,	ईकाईयों,	इकाईयों,	
karybhar,	कार्यभर,	कार्यभार,	
mad,	मैड,	मैड,	
vaigyaanik,	वैग्ञानिक,	वैज्ञानिक,	
dhandon,	ढंंडों,	धंधों,	
rupi,	रूपी,	रूपी,	
mardangi,	मरदांगी,	मर्दानगी,	
vipro,	विप्रो,	विप्रो,	
avantipur,	अवंतिपुर,	अवंतिपुर,	
putali,	पुतली,	पुतली,	
pam,	पाम,	पैम,	
seaten,	सीटन,	सीटें,	
navketan,	नवकेटन,	नवकेतन,	
dit,	दीत,	डिट,	
ulema,	उलेमा,	उलेमा,	
dhari,	धारी,	धारी,	
mam,	माम,	मम,	
angraji,	अंगराजी,	अंग्रज़ी,	
population,	पॉपुलेशन,	पापुलेशन,	
dekhoge,	देखेगे,	देखोगे,	
katra,	कतरा,	कटरा,	
jodta,	जोड़ता,	जोड़ता,	
letkar,	लेटकर,	लेटकर,	
rakhe,	रखे,	राखे,	
jaidayal,	जैदायाल,	जयदयाल,	
dhankuber,	धांबूबार,	धनकुबेर,	
janam,	जन्म,	जानम,	
goyal,	गोयल,	गोयल,	
lagega,	लगेगा,	लगेगा,	
samprbhu,	संप्रभु,	संप्रभु,	
vaisley,	वैसली,	वेस्ले,	
naivegh,	नैवेघ,	नैवेद्य,	
devnar,	देवनार,	देवनार,	
awaru,	अवरू,	अवरु,	
kant,	कांट,	कांट,	
wadiyon,	वादियों,	वादियों,	
solicitor,	सोलीसिटर,	सॉलिसिटर,	
jai,	जाई,	जय,	
chhah,	छाह,	छह,	
karachana,	कराचना,	करछना,	
korola,	कोरोला,	कोरोला,	
amitao,	अमिताओ,	अमिताव,	
gaanth,	गांठ,	गांठ,	
cradle,	क्रैडल,	क्रैडल,	
aapdaein,	आपदाएं,	आपदाएं,	
ethhan,	एठन,	ऐठन,	
enzyme,	एंजीम,	एंजाइम,	
aabantit,	आबंतित,	आबंटित,	
bk,	बीके,	बीके,	
chi,	ची,	ची,	
wajood,	वाजूद,	वजूद,	
aalochak,	आलोचक,	आलोचक,	
wolv,	वोल्व,	वाल्व,	
marrej,	मैरेज,	मैरेज,	
map,	मैप,	माप,	
shbana,	शाबना,	शबाना,	
machae,	मचाई,	मचाए,	
khalnayak,	खलनायक,	खलनायक,	
vipritata,	विप्रितता,	विपरीतता,	
sapariwar,	सप्रिवार,	सपरिवार,	
valkan,	वलकन,	वल्कन,	
naamdhari,	नामधारी,	नामधारी,	
chaukhate,	चौखते,	चौखटे,	
salahkaar,	सलाहकार,	सलाहकार,	
ainthey,	ऐंठे,	ऐंठे,	
beni,	बेनी,	बैनी,	
dhrupad,	ध्रुपद,	ध्रुपद,	
khajrana,	खजराना,	खजराना,	
baraamad,	बरामद,	बरामद,	
nawanagar,	नवानगर,	नवानगर,	
rugan,	रुगाण,	रुग्ण,	
shrimati,	श्रीमती,	श्रीमति,	
ikvitija,	इक्वितिजा,	इक्विटीज,	
kakkad,	कक्कड़,	कक्कड़,	
shervasiyon,	शेरवासियों,	शहरवासियों,	
jamayaa,	जमाया,	जमाया,	
udaanon,	उदानों,	उड़ानों,	
alii,	एली,	अली,	
baraat,	बरात,	बरात,	
ekaki,	एकाकी,	एकाकी,	
sthitiyan,	स्थितियां,	स्थितियां,	
kaivelari,	कैवेलारी,	कैवेलरी,	
mauma,	मौमा,	मौमा,	
doranda,	डोरंडा,	डोरंडा,	
aswbhavik,	अस्वाभाविक,	अस्वभाविक,	
pushp,	पुष्प,	पुष्प,	
veronika,	वेरोनिका,	वेरोनिका,	
born,	बोर्न,	बोर्न,	
amitav,	अमितव,	अमिताव,	
nations,	नेशियंस,	नेशंस,	
pashtun,	पश्टुन,	पश्तून,	
raji,	राजी,	राजी,	
farookhabad,	फरूखाबाद,	फर्रुखाबाद,	
ijaajat,	इजाज़त,	इजाजत,	
seto,	सीटो,	सेटो,	
tasir,	तसीर,	तासीर,	
vyagra,	व्याग्रा,	व्यग्र,	
sarhind,	सरहिंद,	सरहिंद,	
lehna,	लहना,	लहना,	
ashrafi,	अशरफी,	अशरफी,	
eyarve,	एयरवे,	एयरवे,	
tantro,	टंंट्रो,	तंत्रों,	
soond,	सुंद,	सूंड़,	
baarahamaasee,	बारहमासी,	बारहमासी,	
chabate,	चबते,	चबाते,	
bhutto,	भूट्टो,	भुट्टो,	
aadaan,	आदान,	आदान,	
ashktta,	अशक्तता,	अशक्तता,	
around,	अराउंड,	अराउंड,	
salary,	सालारी,	सैलरी,	
pau,	पाऊ,	पौ,	
baldvin,	बलदवीन,	बाल्डविन,	
kumavat,	कुमावत,	कुमावत,	
nemo,	नेमो,	नेमो,	
prakshepak,	प्रक्षेपक,	प्रक्षेपक,	
chahunaur,	चानुआौर,	चहुंओर,	
badali,	बदली,	बदली,	
aadhin,	आधिन,	आधीन,	
kathor,	कैथोर,	कठोर,	
machano,	मचानों,	मचानों,	
jood,	जूड,	जूड,	
namkeen,	नमकीन,	नमकीन,	
algavvadi,	अलगावाड़ी,	अलगाववादी,	
langaron,	लंगारों,	लंगरों,	
artha,	अर्था,	अर्थ,	
raghuram,	रघुराम,	रघुराम,	
maryaadaaon,	मर्यदाओं,	मर्यादाओं,	
mud,	मुड,	मूड,	
sabhen,	सभें,	सभाएं,	
chadron,	चद्रों,	चादरों,	
bajaj,	बजाज,	बजाज,	
tapakti,	तपक्ती,	टपकती,	
samuels,	सममेल्स,	सैम्युल्स,	
arya,	आर्य,	आर्यों,	
dadreva,	दद्रेव,	ददरेवा,	
sankhyayen,	संख्याएं,	संख्याएं,	
vayana,	वायना,	वायना,	
jadeite,	जड़ेते,	जड़ित,	
mungeri,	मंगरी,	मुंगेरी,	
dastavej,	दस्तावेज,	दस्तावेज,	
umesh,	उमेश,	उमेश,	
mate,	मेट,	मेट,	
alnkaron,	अलंकरों,	अलंकारों,	
finger,	फिंगर,	फिंगर,	
wahikayan,	वाहिकाएं,	वाहिकाएं,	
mohana,	मोहना,	मोहाना,	
registan,	रजिस्तान,	रेगिस्तान,	
aavishkaar,	आविष्कार,	आविष्कार,	
mahavigyan,	महाविज्ञान,	महाविज्ञान,	
devisingh,	देविसिंह,	देवीसिंह,	
east,	ईस्ट,	ईष्ट,	
kshitij,	क्षितिज,	क्षितिज,	
chausingha,	चौसिंघ,	चौसिंगा,	
haalchal,	हालचाल,	हालचाल,	
harana,	हराना,	हारना,	
nauner,	नॉनर,	नौनेर,	
prayasarat,	प्रयासरत,	प्रयासरत,	
boliye,	बोलीय,	बोलिए,	
uttara,	उतरता,	उत्तरा,	
padadhikari,	पद्धाकिरी,	पदाधिकारी,	
kaagaz,	कागज़,	कागज़,	
chipkane,	चिपकाने,	चिपकने,	
thaanvi,	ठानवी,	थानवी,	
cbse,	सीबीएस,	सीबीएसई,	
landal,	लंडल,	लेंडल,	
geneva,	जेनेवा,	जिनीवा,	
shmil,	श्मील,	शमिल,	
kursiyon,	कुरसियों,	कुर्सियों,	
poonjikaran,	पूंजीकरण,	पूंजीकरण,	
parshdon,	परशादों,	पार्षदों,	
harvansh,	हरवंश,	हरवंश,	
gahmagahmi,	गहमगाही,	गहमागहमी,	
bediyan,	बेडियां,	बेड़ियां,	
jamana,	जमाना,	ज़माना,	
abhimat,	अभिमत,	अभिमत,	
sabmission,	सैंबिशन,	सबमिशन,	
chennai,	चेननाई,	चेन्नई,	
suken,	सुकेन,	सुजेन,	
astar,	अस्तार,	एस्टर,	
vyavadhan,	व्यवधान,	व्यवधान,	
wastinghouse,	वास्टिंगस,	वेस्टिंगहाउस,	
thikane,	ठीकने,	ठिकाने,	
jalbhrav,	जलभराव,	जलभराव,	
boston,	बोस्तों,	बॉस्टन,	
vishanu,	विषाणु,	विष्णु,	
hostess,	हास्टेस,	होस्टेस,	
spelar,	स्पेलर,	स्पेलर,	
udghosh,	उद्घोष,	उदघोष,	
rupesh,	रूपेश,	रुपेश,	
jaino,	जैनो,	जैनों,	
avrodhk,	अवरोधक,	अवरोधक,	
sahkalakar,	सहकलाकर,	सहकलाकार,	
flin,	फ्लिन,	फ्लिन,	
tied,	टाईड,	टायर्ड,	
upadraviyon,	उपद्रवियों,	उपद्रवियों,	
niya,	निया,	निया,	
raubadar,	रौबादार,	रौबदार,	
putliyon,	पुत्लियों,	पुतलियों,	
mysore,	मैसोर,	मैसोर,	
ishita,	इशिता,	इशिता,	
sanskurt,	संसकर्त,	संस्कृत,	
chhagla,	छगला,	छागला,	
shahrvasiyon,	शहरवासियों,	शहरवासियों,	
datson,	दत्सों,	डैटसन,	
singapore,	सिंगपोर,	सिंगापुर,	
daabholkar,	दाभोलकर,	दाभोलकर,	
najeem,	नजीम,	नजीम,	
cubes,	क्यूबेस,	क्यूब्स,	
programmers,	प्रोग्रामर्स,	प्रोग्रामर्स,	
pahanate,	पहनते,	पहनते,	
sheershakon,	शीर्षकों,	शीर्षकों,	
sanyukta,	सानयुक्त,	संयुक्त,	
anaavashyak,	अनावाश्का,	अनावश्यक,	
shavkon,	शावकों,	शावकों,	
sanskaari,	संस्कारी,	संस्कारी,	
gayitri,	गायीत्री,	गायत्री,	
avarodhak,	अवरोधक,	अवरोधक,	
fogat,	फोगत,	फोगाट,	
amanat,	अमानत,	अमानत,	
nna,	नना,	नना,	
dakhile,	दख़ले,	दाखिले,	
sanskrit,	संस्कृत,	संस्कृत,	
pathykramon,	पाठ्यक्रमों,	पाठ्यक्रमों,	
labelo,	लेबलो,	लेबलों,	
sajja,	सज्जा,	सज्जा,	
vyvhargat,	व्यारागात,	व्यवहारगत,	
chamkana,	चमकाना,	चमकना,	
yudhrat,	युद्धत,	युद्धरत,	
judaai,	जुडाई,	जुदाई,	
udaa,	उड़ा,	उदा,	
durniti,	दुर्नीति,	दुर्नीति,	
kmere,	कमेरे,	कमेरे,	
ainth,	ऐंठ,	ऐंठ,	
lagatar,	लगातार,	लागातार,	
darawani,	दरवानी,	डरावनी,	
theater,	ठीटर,	थियेटर,	
andha,	अंधा,	अंधा,	
aerobic,	एयरोबिक,	एरोबिक,	
csi,	सीसीआई,	सीएसआई,	
shrankhalaaon,	श्रृंखलाओं,	श्रंखलाओं,	
tyoiharon,	त्योहारों,	त्यौहारों,	
dhaagaa,	धागा,	धागा,	
shaun,	शौन,	शॉन,	
luxor,	लुक्सर,	लक्सर,	
barpaayaa,	बर्पाया,	बरपाया,	
prahlad,	प्रहलाद,	प्रहलाद,	
shipra,	शिप्र,	शिप्रा,	
langar,	लंगार,	लंगर,	
samaadhaan,	समाधान,	समाधान,	
moryon,	मोर्यों,	मौर्यों,	
soharai,	सोहराई,	सोहराई,	
mates,	मैट्स,	मेट्स,	
bhay,	भाय,	भय,	
hippopotamus,	हिप्पोप्मासु,	हिप्पोपोटेमस,	
sapane,	सपने,	सपने,	
mhavidyan,	महाविद्ञान,	महाविज्ञान,	
purzon,	पुर्जों,	पुर्जों,	
ghontne,	घोंटने,	घोंटने,	
mhajan,	महाजन,	महाजन,	
ghasi,	घसी,	घासी,	
jamuei,	जमुए,	जमुई,	
idle,	आइडले,	आइडल,	
prashasanik,	प्रशासनिक,	प्रशासनिक,	
vaan,	वान,	वाण,	
saptkraanti,	सप्त्रांति,	सप्तक्रांति,	
kaningham,	कनिन्हम,	कनिंघम,	
vatanukulan,	वातानुकूलन,	वातानुकूलन,	
urvarta,	उर्वरता,	उर्वरता,	
jenrick,	जेनरिक,	जेनरिक,	
jainon,	जैनों,	जैनों,	
basava,	बसवा,	बसावा,	
kanblon,	कांबलों,	कंबलों,	
mular,	मूलर,	मूलर,	
bichhua,	बिछुआ,	बिछुआ,	
gomake,	गोमके,	गोमके,	
theaters,	थीटर्स,	थिएटर्स,	
sitaharan,	सितहरान,	सीताहरण,	
rozlyn,	रोजलीन,	रोजलिन,	
lakshmidhar,	लक्ष्मीधार,	लक्ष्मीधर,	
pichde,	पिछड़े,	पिछड़े,	
raghavan,	रघवान,	राघवन,	
pizza,	पिज्ज़ा,	पिज्जा,	
shrinkhalaon,	श्रृंखलाओं,	श्रंखलाओं,	
policy,	पॉलिसी,	पालिसी,	
anchahe,	अंचाहे,	अनचाहे,	
kambalon,	कांबलों,	कंबलों,	
sarkaa,	सरका,	सरका,	
gulshan,	गुलशान,	गुलशन,	
farookhnagar,	फरूखनागर,	फर्रूखनगर,	
fawaara,	फवारा,	फव्वारा,	
baljeet,	बलजीत,	बलजीत,	
pahno,	पहनो,	पहनो,	
junagarh,	जुनागढ़,	जूनागढ,	
stre,	स्ट्रे,	स्ट्रे,	
gatisheel,	गतिशील,	गतिशील,	
naino,	नैनो,	नैनो,	
arica,	अरिका,	एरिका,	
rupak,	रूपक,	रूपक,	
palaari,	पलारी,	पलारी,	
ubhaara,	उभारा,	उभारा,	
dikhayi,	दिखाई,	दिखाई,	
billa,	बिल्ला,	बिल्ला,	
balli,	बल्ली,	बल्ली,	
jhuthla,	झुठला,	झुठला,	
chithhi,	चित्ही,	चिठ्ठी,	
paarampariktaa,	पारंपारिकता,	पारंपरिकता,	
sooraj,	सुराज,	सूरज,	
bazaru,	बाजरू,	बाजारू,	
jatara,	जातारा,	जतरा,	
abaru,	अबारू,	आबरू,	
chor,	चोर,	चोर,	
abut,	अबूत,	एबट,	
pushpa,	पुष्प,	पुष्पा,	
nabja,	नब्जा,	नब्ज़,	
sahrawat,	सहरावत,	सहरावत,	
parishad,	परिशाद,	परिषद,	
spear,	स्पेयर,	स्पीयर,	
vyagr,	व्याग्र,	व्यग्र,	
kanika,	कानिका,	कणिका,	
sandli,	सांडली,	संदली,	
ishat,	इशात,	ईष्ट,	
form,	फॉर्म,	फार्म,	
katthai,	कट्ठाई,	कत्थई,	
rajtantra,	राजतंत्र,	राजतंत्र,	
bilai,	बिलाई,	बिलाई,	
bhupsingh,	भूपसिंघ,	भूपसिंह,	
osaka,	ओसका,	ओसाका,	
peranormal,	पेरानोमाल,	पैरानॉर्मल,	
notes,	नोट्स,	नोट्स,	
ulahna,	उलाहना,	उलाहना,	
laksar,	लकसार,	लक्सर,	
pathshalayein,	पथठालाएं,	पाठशालाएं,	
mathe,	मठे,	माथे,	
aasan,	आसन,	आसान,	
pitaamaha,	पितामाह,	पितामह,	
padaraunaa,	पदारौणा,	पडरौना,	
purane,	पुराने,	पुराने,	
verbal,	वर्बल,	वर्बल,	
apardarshi,	अपरदर्शी,	अपारदर्शी,	
failaaiye,	फैलाइए,	फैलाइए,	
avaru,	अवरू,	अवरु,	
kaku,	काकू,	काकू,	
tribunal,	ट्रिब्यूनल,	ट्रिब्युनल,	
maulaviyon,	मौलवियों,	मौलवियों,	
ralaud,	रालौद,	रालोद,	
simi,	सीमी,	सिमी,	
aamdani,	आमदनी,	आमदनी,	
sk,	एसके,	एसके,	
hanfte,	हैंफते,	हांफते,	
mahagranth,	महाग्रंथ,	महाग्रंथ,	
dhatna,	धाटना,	धटना,	
bulao,	बुलाओ,	बुलाओ,	
avranta,	अवरंता,	अवर्णता,	
chandramaon,	चंद्रमाओं,	चंद्रमाओं,	
jua,	जुआ,	जुए,	
diaries,	डायरीज,	डायरीज,	
deshke,	देशके,	देशके,	
thakkr,	ठक्कर,	ठक्कर,	
lavasa,	लावासा,	लवासा,	
kochi,	कोची,	कोच्चि,	
navvadhu,	नववाधु,	नववधू,	
shaharwasiyon,	शहरवासियों,	शहरवासियों,	
vipreetataa,	विप्रीता,	विपरीतता,	
ti,	टी,	ती,	
mango,	मंगो,	मांगो,	
vaahikayen,	वाहिकाएं,	वाहिकाएं,	
darjanon,	दरजानों,	दर्जनों,	
dali,	डाली,	दली,	
ear,	एयर,	इअर,	
naxaliyon,	नक्सलियों,	नक्सलियों,	
banthia,	बंठिया,	बांठिया,	
paradheen,	पराधीन,	पराधीन,	
iter,	आइटर,	ईटर,	
kamottejana,	कमोट्टेजना,	कामोत्तेजना,	
nazarandaz,	नजरअंदाज़,	नजरंदाज,	
singhade,	सिंहड़े,	सिंघाड़े,	
bhookh,	भूख,	भूख,	
mahinon,	महीनों,	महीनों,	
dharmnath,	धर्मनाथ,	धर्मनाथ,	
gunga,	गुंगा,	गूंगा,	
jadit,	जड़ित,	जड़ित,	
yaduvansh,	यदुवंश,	यदुवंश,	
vivekahin,	विवेकाहीन,	विवेकहीन,	
barasingha,	बरससिंह,	बारहसिंगा,	
jivaniyan,	जीवनियां,	जीवनियां,	
gsm,	जीएसएम,	जीएसएम,	
wicket,	विकेट,	विकेट,	
phogat,	फोगत,	फोगाट,	
nights,	नाइट्स,	नाइट्रस,	
sanshayon,	संशायों,	संशयों,	
kaushambi,	कौशंबी,	कौशाम्बी,	
mahavidya,	महाविद्य,	महाविद्या,	
sansthit,	संस्थित,	संस्थित,	
official,	आफिसियल,	ऑफिशियल,	
mul,	मूल,	मूल,	
jeevniyaan,	जीवनियां,	जीवनियां,	
telon,	टेलों,	तेलों,	
baadhaon,	बाधाओं,	बाधाओं,	
benwar,	बेंवर,	बेंवर,	
bhayo,	भायो,	भयो,	
offshor,	आफफर,	ऑफशोर,	
devi,	देवी,	देवी,	
chipakane,	चिपकाने,	चिपकने,	
trouble,	ट्रबल,	ट्रेबल,	
durbhiksh,	दुर्भिक्ष,	दुर्भिक्ष,	
truck,	ट्रक,	ट्रक,	
navjagran,	नवजागरण,	नवजागरण,	
jamaate,	जमाते,	जमाती,	
khaate,	खाते,	खाते,	
prarup,	प्रारूप,	प्रारूप,	
catholic,	कैथलिक,	कैथोलिक,	
pratibhutiyan,	प्रतिभूतियां,	प्रतिभूतियां,	
amit,	अमिट,	अमित,	
caitlyn,	कैटिलन,	कैटलिन,	
dharmesh,	धर्मेश,	धर्मेश,	
khurpaka,	खुरपका,	खुरपका,	
bang,	बांग,	बंग,	
nidhaan,	निधान,	निधान,	
rate,	रेट,	रेत,	
seem,	सीम,	सीम,	
peaking,	पीकिंग,	पीकिंग,	
endometrial,	एंडोमेट्रियल,	एंडोमेट्रियल,	
lajjalu,	लजजालू,	लज्जालु,	
bahrupiya,	बहरूपीय,	बहरूपिया,	
pakhandi,	पाखंडी,	पाखंडी,	
sweta,	स्वेता,	स्वेता,	
lanchar,	लांचार,	लांचर,	
kinote,	किनोट,	कीनोट,	
avishkar,	अविष्कार,	आविष्कार,	
rampur,	रामपुर,	रामपुर,	
sandarbha,	संदर्भ,	संदर्भ,	
mainan,	मैनन,	मैनन,	
sube,	सब,	सूबे,	
saabah,	साबाह,	साबाह,	
rental,	रेंटल,	रेंटल,	
jaun,	जौन,	जौं,	
krantiyon,	क्रांतियों,	क्रांतियों,	
swecha,	स्वेच्छ,	स्वेच्छा,	
nageene,	नगीने,	नगीने,	
untees,	ऊंटीस,	उनतीस,	
harshit,	हर्शित,	हर्षित,	
nirdharit,	निर्धारित,	निर्धारित,	
chkkar,	चक्कर,	चक्कर,	
paraadheen,	पराधीन,	पराधीन,	
asthetic,	एस्थेटिक्स,	एस्थेटिक,	
chausinga,	चौसिंगा,	चौसिंगा,	
baila,	बैला,	बैला,	
varsaache,	वर्साचे,	वर्साचे,	
vardhmaan,	वर्धमान,	वर्द्धमान,	
tapuwo,	टपुवो,	टापुओं,	
cutlery,	कटली,	कटलरी,	
phoda,	फोडा,	फोड़ा,	
fund,	फुंड,	फंड,	
aamdan,	आमदन,	आमदन,	
aakash,	आकाश,	आकाश,	
tapkati,	तपकती,	टपकती,	
valkkan,	वाल्कन,	वल्कन,	
saira,	सैरा,	सायरा,	
daddy,	डैड्डी,	डैडी,	
bagabani,	बागबानी,	बागबानी,	
sriram,	श्रीरम,	श्रीराम,	
tasting,	टास्टिंग,	टेस्टिंग,	
naksalwad,	नकसलवाद,	नक्सलवाद,	
mathey,	मठे,	माथे,	
submission,	सब्यीशन,	सबमिशन,	
narayangarh,	नारायंगढ़,	नारायणगढ़,	
pratiyon,	प्रतियों,	प्रतियों,	
talve,	तलवे,	तलवे,	
aviva,	अविवा,	अवीवा,	
cube,	क्यूब,	क्यूब,	
siddhvat,	सिद्धवत,	सिद्धवट,	
salahkar,	सलाहकर,	सलाहकार,	
saltanat,	सल्टानट,	सल्तनत,	
neg,	नेग,	नेग,	
vidhivat,	विधिवत,	विधिवत,	
rajman,	राजमान,	राजमां,	
dhoondh,	ढूंध,	ढूंढ,	
sarahind,	सरहींद,	सरहिंद,	
pehan,	पहन,	पहन,	
trot,	ट्रोट,	ट्रॉट,	
banthiya,	बंठिया,	बांठिया,	
bakayon,	बकायों,	बकायों,	
bhraantiyan,	भ्रांटियां,	भ्रांतियां,	
prapti,	प्राप्ति,	प्राप्ती,	
lurhakate,	लुढ़कते,	लुढ़कते,	
mithai,	मिठाई,	मिठाई,	
tikon,	टीकों,	टीकों,	
shakhayen,	शखाएं,	शाखाएं,	
aadhaarit,	आधारित,	आधारित,	
ehsas,	एहसास,	एहसास,	
shrikhand,	श्रीखंड,	श्रीखंड,	
sawal,	सवाल,	सवाल,	
ahirauli,	अहिरौली,	अहिरौली,	
paramparikata,	परंपरिकता,	पारंपरिकता,	
nanavati,	नानावती,	नानावती,	
badata,	बड़ता,	बढ़ाता,	
rowan,	रोवन,	रोवन,	
savaal,	सवाल,	सवाल,	
lagataar,	लगातार,	लागातार,	
neko,	नेको,	नेको,	
manaye,	मनाए,	मनाए,	
short,	शोर्ट,	शोर्ट,	
bosaan,	बोसान,	बोसान,	
sooja,	सूजा,	सूजा,	
astik,	आस्तिक,	आस्तिक,	
amrohi,	अमरोही,	अमरोही,	
to,	टो,	तो,	
saptpadi,	सप्तपादी,	सप्तपदी,	
rugna,	रुग्ण,	रुग्ण,	
guan,	गुआन,	गुआन,	
poojapath,	पूजापथ,	पूजापाठ,	
taoo,	ताओ,	टाऊ,	
letakar,	लेटकर,	लेटकर,	
vaigyaanikta,	वैज्ञानिकता,	वैज्ञानिकता,	
malaga,	मलगा,	मलागा,	
bhadkaya,	भड़काया,	भड़काया,	
asamanjasy,	असमंजस्य,	असामंजस्य,	
pharase,	फरासे,	फरसे,	
anant,	अनांत,	अनंत,	
manchiya,	मांचिया,	मंचीय,	
soma,	सोमा,	सोमा,	
sanyogvash,	संयोगवाश,	संयोगवश,	
trijta,	त्रिजता,	त्रिजटा,	
judae,	जुड़ाए,	जुड़ाई,	
jira,	जीरा,	जीरा,	
aawazon,	आवाजों,	आवाज़ों,	
bewkufana,	बेवकूफना,	बेवकूफाना,	
patiya,	पटिया,	पटिया,	
manzilein,	मंजीलें,	मंजिलें,	
marmar,	मरमार,	मरमर,	
hahakar,	हहकर,	हाहाकार,	
dwivedi,	द्विवेदी,	द्विवेदी,	
saym,	सायम,	सायं,	
lakiron,	लाकिरों,	लकीरों,	
saleeb,	सलीब,	सलीब,	
jeepney,	जीपने,	जीपनी,	
vikalpon,	विकल्पों,	विकल्पों,	
suction,	सक्टन,	सक्शन,	
masur,	मसूर,	मसूर,	
sapney,	सपने,	सपने,	
kaagaj,	कागज,	कागज़,	
advivas,	अद्विवस,	अधिवास,	
punchang,	पंचांग,	पंचांग,	
bilae,	बिलाए,	बिलाई,	
avi,	एवी,	अवि,	
lalla,	लाला,	लल्ला,	
satluj,	सतलुज,	सतलुज,	
chhupata,	छुपटा,	छुपता,	
saparivaar,	सप्रिवार,	सपरिवार,	
vineet,	विनीत,	विनीत,	
ashriton,	अश्रीतों,	आश्रितों,	
dikhaain,	दिखाइएं,	दिखाईं,	
dhyeywadi,	ध्येववादी,	ध्येयवादी,	
sandrbhon,	संद्रभों,	संदर्भों,	
denewaali,	देनेवाली,	देनेवाली,	
yojanaein,	योजनाएं,	योजनाएं,	
ftii,	फ्टी,	एफटीआईआई,	
classen,	क्लासेन,	क्लासें,	
ruktey,	रुकते,	रुकते,	
deepsingh,	दीपसिंह,	दीपसिंह,	
tennis,	टेनिस,	टैनिस,	
hostes,	होस्टेस,	होस्टेस,	
wealth,	वेल्थ,	वेल्थ,	
girijaghar,	गिरिजाघर,	गिरजाघर,	
simmons,	सिमंनस,	साइमंस,	
siyah,	सियाह,	सियाह,	
pichhade,	पिछड़े,	पिछड़े,	
privacy,	प्रिवेसी,	प्राइवेसी,	
sanskar,	संस्कर,	संस्कार,	
yaatna,	यातना,	यातना,	
dukhit,	दुखित,	दुखित,	
jenny,	जेनी,	जेनी,	
junagadh,	जूनागढ़,	जूनागढ,	
ayodhyeanath,	अयोध्यननाथ,	अयोध्यानाथ,	
thiyeters,	थियरटर्स,	थियेटर्स,	
ishak,	इशक,	इशाक,	
teji,	तेजी,	तेजी,	
chhuri,	छुरी,	छुरी,	
bechate,	बेचते,	बेचते,	
chauda,	चौड़ा,	चौड़ा,	
batlaae,	बतलाए,	बतलाए,	
routing,	रॉटिंग,	रूटिंग,	
kavvaliyon,	कववालियों,	कव्वालियों,	
prathmikta,	प्राथमिकता,	प्राथमिकता,	
gemhagehmi,	गेमहगमही,	गहमागहमी,	
tapmanon,	तप्मानों,	तापमानों,	
locket,	लॉकेट,	लॉकेट,	
najibabad,	नजीबाबाद,	नजीबाबाद,	
jalvayu,	जलवायु,	जलवायु,	
manjila,	मंजीला,	मंजिला,	
de,	डे,	डीई,	
birth,	बीर्थ,	बर्थ,	
chhudaane,	छुड़ाने,	छुडाने,	
banva,	बनवा,	बनवा,	
heros,	हेरोस,	हीरोज,	
taapmaanon,	ताप्मानों,	तापमानों,	
pigmentation,	पिग्मेंटेशन,	पिगमेंटेशन,	
feka,	फेका,	फेका,	
jeevant,	जीवंत,	जीवंत,	
aalha,	आल्हा,	आल्हा,	
amarohi,	अमरोही,	अमरोही,	
sujan,	सुजन,	सुजेन,	
dhoraaji,	धोरजी,	धोराजी,	
atta,	अत्ता,	आटा,	
patrani,	पत्रणी,	पटरानी,	
dhuriyaa,	धुरिया,	धुरिया,	
jeremy,	जेरेमी,	जेरेमी,	
jokhim,	जोखिम,	जोखिम,	
urvarakon,	उर्वरकों,	उर्वरकों,	
urff,	आर्फ,	उर्फ,	
ronit,	रोनिट,	रोनित,	
vegyanik,	वेज्ञानिक,	वैज्ञानिक,	
majin,	माजीन,	माजिन,	
raees,	राईस,	रईस,	
mool,	मूल,	मूल,	
arth,	अर्थ,	अर्थ,	
ankon,	अंकों,	अंकों,	
udaanen,	उड़नें,	उड़ानें,	
jaylalita,	जयललातिता,	जयललिता,	
bakse,	बकसे,	बक्से,	
ramraj,	रामराज,	रामराज,	
audyogikarana,	औद्योगिकरण,	औद्योगिकरण,	
barhad,	बरहद,	बरहद,	
badhaon,	बढ़ाओं,	बाधाओं,	
jadd,	जड्द,	जड़,	
chest,	चेस्ट,	चेस्ट,	
moshe,	मोशे,	मोशे,	
madhupur,	मधुपुर,	मधुपुर,	
poshit,	पोषित,	पोषित,	
baadhaaon,	बाधाओं,	बाधाओं,	
gross,	ग्रॉस,	ग्रॉस,	
tanta,	टांटा,	तांता,	
kalmein,	कलमें,	कलमें,	
sensing,	सेंसिंग,	सेंसिंग,	
pratigya,	प्रतिज्ञ,	प्रतिज्ञा,	
jenni,	जेन्नी,	जेनी,	
dramen,	ड्रमेन,	ड्रामे,	
maason,	मासों,	मासों,	
avarnata,	अवर्नता,	अवर्णता,	
singhaadey,	सिंहाड़े,	सिंघाड़े,	
bhavanaon,	भवनाओं,	भावनाओं,	
halla,	हल्ला,	हल्ला,	
ayodhyanath,	अयोध्यनाथ,	अयोध्यानाथ,	
jadein,	जड़ें,	जड़ें,	
chan,	चान,	चान,	
kazi,	काज़ी,	काजी,	
aashriton,	आश्रितों,	आश्रितों,	
louis,	लॉईस,	लुईस,	
vyatit,	व्यतित,	व्यतीत,	
anuthi,	अनुठी,	अनूठी,	
ghise,	घीसे,	घिसे,	
pythagoras,	पिथागोरस,	पाइथागोरस,	
uthen,	उठाें,	उठें,	
sherawat,	शेरावत,	सहरावत,	
biji,	बीजी,	बिजी,	
kaldwell,	कालद्वेल,	काल्डवेल,	
routes,	राउट्स,	रूट्स,	
marriage,	मैरेज,	मैरेज,	
broke,	ब्रोक,	ब्रोक,	
jagriti,	जागरीति,	जागृति,	
sohaval,	सोहावल,	सोहावल,	
nayak,	नायक,	नायक,	
dhandhon,	ढांधों,	धंधों,	
prathmik,	प्राथमिक,	प्राथमिक,	
neat,	नीट,	नीट,	
baitul,	बैटुल,	बैतूल,	
devisinh,	देविसिनह,	देवीसिंह,	
ganguly,	गंगुल्य,	गांगुली,	
bandhan,	बांधन,	बंधान,	
astin,	एस्तीन,	आस्तीन,	
dharak,	धारक,	धारक,	
rushikul,	ऋषिकिल,	ऋषिकुल,	
panpana,	पनपना,	पनपना,	
siddhivat,	सिद्धिवत,	सिद्धवट,	
kathore,	कठोरे,	कठोर,	
sulkhan,	सुलखान,	सुलखान,	
billaa,	बिल्ला,	बिल्ला,	
vaishaakhi,	वैशाखी,	वैशाखी,	
caolan,	कॉलन,	कोलन,	
convocation,	कन्वोकेशन,	कन्वोकेशन,	
suljayi,	सुलजाई,	सुलझाई,	
bharakaaya,	भड़काया,	भड़काया,	
vidyaon,	विद्याओं,	विद्याओं,	
wipro,	वाप्रो,	विप्रो,	
vidhaaein,	विधाएं,	विद्याएं,	
vareinye,	वरेनी,	वरेण्य,	
gaumukh,	गौमुख,	गौमुख,	
atthaas,	अत्थास,	अट्टहास,	
lakhkhi,	लखखी,	लख्खी,	
egmore,	एग्मोर,	एगमोर,	
vinit,	विनित,	विनीत,	
dhaatuyein,	धातुएं,	धातुएं,	
mubarakpur,	मुबराकपुर,	मुबारकपुर,	
asamany,	असामान्य,	असमान्य,	
mahanirdeshak,	महानिर्देशक,	महानिदेशक,	
guman,	गुमान,	गुमान,	
prapta,	प्राप्त,	प्राप्त,	
asphault,	असफौल्ट,	एस्फाल्ट,	
fadfadata,	फड़फाड़ता,	फड़फड़ाता,	
nahargadh,	नहर्गढ़,	नाहरगढ,	
shakhayan,	शखायां,	शाखाएं,	
anureet,	अनुरीत,	अनुरीत,	
khani,	खानी,	खनि,	
baljit,	बलजीत,	बलजीत,	
cleris,	क्लेरिस,	क्लेरिस,	
pintaa,	पिंता,	पिंटा,	
racreation,	रैक्रेशन,	रिक्रिएशन,	
dikhaaiye,	दिखाइए,	दिखाइये,	
harjeet,	हरजीत,	हारजीत,	
lairy,	लेरी,	लैरी,	
bawara,	बावरा,	बावरा,	
pendulum,	पेंडुलम,	पेंडुलम,	
tantra,	टंंत्रा,	तंत्र,	
pib,	पीब,	पीआईबी,	
amargad,	अमरगाद,	अमरगढ़,	
kahaniyon,	कहानियों,	कहानियों,	
muflisi,	मुल्सीसी,	मुफलिसी,	
dampati,	दमपति,	दंपति,	
naksali,	नकसली,	नक्सली,	
hong,	होंग,	हॉन्ग,	
traded,	ट्रेडेड,	ट्रेडेड,	
greest,	ग्रीस्ट,	ग्रीस्ट,	
bhulon,	भूलों,	भूलों,	
nahargarh,	नहरगाढ़,	नाहरगढ,	
ghatatop,	घटाटोप,	घटाटोप,	
proud,	प्रौड,	प्रौढ,	
pardesiyon,	परदेसियों,	परदेसियों,	
liberation,	लाइब्रेशन,	लिब्रेशन,	
chakkar,	चक्कर,	चक्कर,	
dork,	डोर्क,	डॉर्क,	
jamaya,	जमाया,	जमाया,	
badhaataa,	बढ़ता,	बढ़ाता,	
jhilon,	झिलों,	झीलों,	
pahni,	पहनी,	पहनी,	
himali,	हिमली,	हिमाली,	
england,	एंग्लैंड,	इंग्लैंड,	
jardaa,	जर्दा,	जर्दा,	
venkatraman,	वेंकटरमण,	वेंकटरमन,	
aata,	आता,	आटा,	
jaanam,	जानम,	जानम,	
aadheen,	आधिन,	आधीन,	
roojwelt,	रूजवेल्ट,	रुजवेल्ट,	
drager,	ड्रेजर,	ड्रेजर,	
pitamah,	पीटामह,	पितामह,	
ghoonsa,	घूंसा,	घूंसा,	
pv,	पीवी,	पीवी,	
nadep,	नेडप,	नाडेप,	
usi,	उसी,	उसी,	
narnaari,	नरनारी,	नरनारी,	
sakshan,	सक्षण,	सक्शन,	
melaanin,	मेलानिन,	मेलानिन,	
badhayi,	बढ़ाई,	बढ़ायी,	
baithantey,	बैठांते,	बैठते,	
pipra,	पिप्र,	पिपरा,	
slaaidon,	स्लाइडों,	स्लाइडों,	
amavasya,	अमावस्य,	अमावस्या,	
pehni,	पहनी,	पहनी,	
parshadon,	परशादों,	पार्षदों,	
tippnikar,	टिप्पिणकर,	टिप्पणीकार,	
lindbhed,	लिंदभेद,	लिंगभेद,	
khapat,	खपट,	खपत,	
pradarshan,	प्रदर्शन,	प्रर्दशन,	
sanyojnon,	संयोजनों,	संयोजनों,	
clasen,	क्लेसन,	क्लासें,	
paathyakramon,	पाठ्यक्रमों,	पाठ्यक्रमों,	
manzil,	मंजिल,	मंजिल,	
naxali,	नक्सली,	नक्सली,	
duvidhaaen,	दुविधाएं,	दुविधाएं,	
dikhai,	दिखाई,	दिखाई,	
jhil,	झील,	झील,	
singaar,	सिंगार,	सिंगार,	
rawail,	रावैल,	रवैल,	
dharmraj,	धर्मराज,	धर्मराज,	
nagine,	नैगिन,	नगीने,	
abbaasi,	अब्बासी,	अब्बासी,	
dungerpur,	दंगरपुर,	डूंगरपुर,	
sipahiyon,	सिपाहियों,	सिपाहियों,	
scala,	स्केला,	स्काला,	
parloron,	पार्लों,	पार्लरों,	
swarupon,	स्वरूपों,	स्वरुपों,	
akram,	अक्रम,	अकरम,	
durdarshan,	दूरदर्शन,	दूरदर्शन,	
suhagin,	सुहागीन,	सुहागिन,	
avaigyanic,	अवैज्ञानिक्,	अवैज्ञानिक,	
grist,	ग्रिस्ट,	ग्रीस्ट,	
swipe,	स्वाइप,	स्वैप,	
bachti,	बच्ती,	बचती,	
ashariri,	अशारीरी,	अशरीरी,	
dungarpur,	दुंगरपुर,	डूंगरपुर,	
alasi,	आलसी,	आलसी,	
chinke,	चींके,	छींके,	
tagde,	तगड़े,	तगड़े,	
narbhakshi,	नारभक्षी,	नरभक्षी,	
amanati,	अमानती,	अमानती,	
charton,	चार्टन,	चार्टों,	
nauvahan,	नौवाहन,	नौवहन,	
jain,	जैन,	जैन,	
jeera,	जीरा,	जीरा,	
mauley,	मौले,	मौले,	
chuka,	चूका,	चुका,	
ibija,	इबिजा,	इबीजा,	
parosne,	परोसने,	परोसने,	
shamil,	शामिल,	शमिल,	
chhaapemaar,	छापेमार,	छापेमार,	
suryadev,	सूर्यदेव,	सूर्यदेव,	
anavashyak,	अनावाश्क,	अनावश्यक,	
naushad,	नौषद,	नौशाद,	
kacche,	कच्छे,	कच्चे,	
nikalegi,	निकलेगी,	निकलेगी,	
apvtrit,	अप्वत्रित,	अपवर्तित,	
pulmonary,	प्लोनारी,	पल्मोनरी,	
gujarte,	गुजरते,	गुजारते,	
jaatak,	जाटक,	जातक,	
mejbaani,	मेजबानी,	मेज़बानी,	
pakaayen,	पकाएं,	पकाएं,	
mhamantra,	महामंत्र,	महामंत्र,	
mukhyopadhyaay,	मुख्योपाधायाय,	मुखोपाध्याय,	
mulchand,	मूलचंद,	मूलचंद,	
paathshaalaayein,	पाठशालाएं,	पाठशालाएं,	
anand,	आनंद,	आनद,	
bulletin,	बुलेटिन,	बुलेटिन,	
khoya,	खोया,	खोया,	
braat,	ब्रात,	बरात,	
uplabdhiyon,	उपलबधियों,	उपलब्धियों,	
munaf,	मुनाफ,	मुनाफ,	
vastvik,	वास्त्विक,	वास्तविक,	
mahasingh,	महासिंह,	महासिंह,	
nikaalani,	निकालनी,	निकालनी,	
ekatthi,	एकट्ठी,	इकठ्ठी,	
divya,	दिव्य,	दिव्य,	
vyaghat,	व्याघात,	व्याघात,	
fefada,	फेफडा,	फेफड़ा,	
test,	टेस्ट,	टेस्ट,	
bajuon,	बाजुओं,	बाजुओं,	
ahyan,	आह्ञान,	आह्नान,	
varshan,	वर्षण,	वर्शन,	
maajin,	माजीन,	माजिन,	
chhetr,	छेत्र,	छेत्र,	
gosvaami,	गोस्वामी,	गोस्वामी,	
introduction,	इंट्रोक्शक्शन,	इंट्रोडक्शन,	
gujarata,	गुजरता,	गुजारता,	
nitiyon,	नितियों,	नीतियों,	
ipc,	आईपीसी,	आईपीसी,	
lives,	लाइव्स,	लाइव्स,	
mhagranth,	महाग्रंथ,	महाग्रंथ,	
tuglakabad,	तुगलाकाबाद,	तुगलकाबाद,	
andheri,	अंधेरी,	अंधेरी,	
raalod,	रालोड,	रालोद,	
saman,	सामन,	समन,	
allah,	अल्लाह,	आल्हा,	
amjhera,	अमझेरा,	अमझेरा,	
bakoul,	बैकल,	बकौल,	
ilayichi,	इलायिची,	इलाइची,	
maratha,	मराठा,	मराठा,	
saajan,	साजन,	साजन,	
lakeer,	लाकीर,	लकीर,	
charon,	चारों,	चारों,	
kamaate,	कमाते,	कमाते,	
ambani,	अंबानी,	अम्बानी,	
dhokebaaz,	धोकेबाज,	धोखेबाज,	
bewakoofaanaa,	बेवकूफना,	बेवकूफाना,	
juraab,	जुराब,	जुराब,	
rukate,	रुकते,	रुकते,	
ubaal,	उबाल,	उबाल,	
purvabhaas,	पूर्वाभास,	पूर्वाभास,	
arya,	आर्य,	आर्य,	
mem,	मेम,	मेम,	
sirhind,	सिरहिंद,	सरहिंद,	
ulte,	उल्टे,	उलटे,	
pehnakar,	पहनाकर,	पहनाकर,	
psv,	पीएसवी,	पीएसवी,	
piloton,	पिलोतों,	पायलटों,	
sahakalaakar,	सहकालाकार,	सहकलाकार,	
arymaa,	अर्यमा,	अर्यमा,	
zarda,	जर्दा,	जर्दा,	
lahalhati,	लहलतही,	लहलहाती,	
kanal,	कनाल,	कनाल,	
ski,	सीकी,	स्की,	
ambaani,	अंबानी,	अंबानी,	
sarkaren,	सरकारें,	सरकारें,	
tantrikao,	तंत्रिकाओं,	तंत्रिकाओं,	
lapetane,	लपेटने,	लपेटने,	
clock,	क्लॉक,	क्लाक,	
jaybaan,	जायबन,	जयबाण,	
rabin,	रबीन,	राबिन,	
uchhalne,	उछलने,	उछालने,	
peary,	पेरी,	पियरी,	
amdi,	अमदी,	आमदी,	
ajmeedh,	अजमीद,	अजमीढ़,	
praneet,	प्रणीत,	प्रनीत,	
aahnaan,	आहानान,	आह्नान,	
chaudhawan,	चौदहवान,	चौदहवां,	
maryada,	मर्यदा,	मर्यादा,	
koot,	कूट,	कूट,	
mundva,	मुंडवा,	मुंडवा,	
rambharosey,	रामभरोसे,	रामभरोसे,	
bosten,	बोस्नें,	बॉस्टन,	
dinaank,	दिनांक,	दिनांक,	
lalpur,	लालपुर,	लालपुर,	
farsi,	फर्सी,	फारसी,	
formulae,	फोर्मुलाई,	फार्मूले,	
pace,	पेस,	पेस,	
jheelon,	झीलों,	झीलों,	
tark,	तर्क,	तर्क,	
winter,	विंटर,	विंटर,	
taahi,	ताही,	ताहि,	
pranon,	प्राणों,	प्राणों,	
dam,	दम,	डम,	
asurkshit,	असुरक्षित,	असुरक्षित,	
sikar,	सिकर,	सीकर,	
earth,	ईर्थ,	अर्थ,	
navate,	नवाते,	नवाते,	
aaryika,	आर्यिका,	आर्यिका,	
insurance,	इनसरोंस,	इंश्योरेंस,	
economic,	इकोनॉमिक,	इकोनोमिक,	
varn,	वर्न,	वर्ण,	
vitthal,	वित्थल,	विठ्ठल,	
pagla,	पगला,	पगला,	
chakatte,	चकतते,	चकत्ते,	
jaunch,	जौंच,	जाँच,	
saayn,	सायन,	सायं,	
reshey,	रेशे,	रेशे,	
barsata,	बरसता,	बरसाता,	
doongarpur,	दूंगरपुर,	डूंगरपुर,	
kartik,	कार्तिक,	कार्तिक,	
maange,	मांगे,	मांगे,	
maalish,	मालीश,	मालिश,	
yaduwansh,	यदुवंश,	यदुवंश,	
suljhai,	सुलझाई,	सुलझाई,	
uplabdh,	उपलबब्ध,	उपलब्ध,	
doordarshan,	दूरदर्शन,	दूरदर्शन,	
grenite,	ग्रेनाइट,	ग्रेनाइट,	
awashist,	अवशिष्ट,	अवशिष्ट,	
quantico,	क्वांटिको,	क्वांटिको,	
plane,	प्लाने,	प्लेन,	
badlapur,	बदलापुर,	बदलापुर,	
kathfodave,	कठ्दोदावे,	कठफोड़वे,	
hijda,	हिजड़ा,	हिजड़ा,	
neelagaay,	नीलगाज,	नीलगाय,	
pushpa,	पुष्प,	पुष्प,	
gypsy,	जिप्सी,	जिप्सी,	
phatne,	फटने,	फटने,	
vidyaayein,	विद्याएं,	विद्याएं,	
orion,	ओरियन,	ओरियन,	
bodra,	बोद्रा,	बोदरा,	
samanwayaka,	समन्वयका,	समन्वयक,	
vidhaaon,	विधाओं,	विद्याओं,	
rishtey,	रिश्ते,	रिश्ते,	
udaan,	उदान,	उड़ान,	
yatnaon,	यतनाओं,	यातनाओं,	
da,	दा,	दा,	
tyohaar,	त्योहार,	त्यौहार,	
masyendranath,	मस्येंध्रनाथ,	मत्स्येंद्रनाथ,	
ekaeyon,	एकाईयों,	इकाईयों,	
asi,	एसी,	एएसआई,	
dradh,	दृद,	दृढ़,	
funda,	फुंडा,	फंडा,	
bhulo,	भूलो,	भूलो,	
order,	आर्डर,	आर्डर,	
yojanaye,	योजनाए,	योजनाएं,	
oxy,	ऑक्सी,	ऑक्सी,	
merraige,	मैरेज,	मैरेज,	
upadrawon,	उपद्रवों,	उपद्रवों,	
nazarandaaz,	नजरअंदाज़,	नजरंदाज,	
lendal,	लेंडल,	लेंडल,	
error,	एरर,	एरर,	
squash,	स्क्यूश,	स्क्वाश,	
ankhon,	आंखों,	अंकों,	
channa,	चानना,	चन्ना,	
baani,	बानी,	बानी,	
raatrichar,	रात्रिचार,	रात्रिचर,	
melanin,	मेलानिन,	मेलानिन,	
lochdar,	लोचदार,	लोचदार,	
aapkaa,	आपका,	आपका,	
ukrainian,	यूक्रेनियन,	यूक्रेनियन,	
batlaye,	बतलाए,	बतलाए,	
radhe,	राढ़े,	राधे,	
sagrika,	सागरिका,	सागरिका,	
vinasht,	विनाष्ट,	विनष्ट,	
soccer,	सॉकर,	सॉकर,	
jhankana,	झांकना,	झांकना,	
hakikat,	हाकिकत,	हकीकत,	
gaytri,	गायत्री,	गायत्री,	
aparivartanshali,	अपरिवर्तनशली,	अपरिवर्तनशील,	
mohani,	मोहनी,	मोहानी,	
alba,	अल्बा,	अल्बा,	
slidon,	स्लाइडन,	स्लाइडों,	
wesle,	वेसल,	वेस्ले,	
khaaskar,	खासकर,	ख़ासकर,	
vyaktigat,	व्यक्तिगत,	व्यक्तिगत,	
formule,	फॉर्मूल,	फार्मूले,	
siswa,	सिस्वा,	सिसवा,	
tughlaq,	तुगलाक,	तुगलक,	
vartaman,	वर्तमान,	वर्तमान,	
vanshdhar,	वंशधर,	वंशधर,	
sanketik,	संकेटिक,	सांकेतिक,	
shujat,	शुजतत,	शुजात,	
shatpath,	शट्पथ,	शतपथ,	
atakta,	अटकता,	अटकता,	
pushkarna,	पुष्करण,	पुष्करणा,	
emrald,	एमराल्ड,	एमरल्ड,	
thanvi,	ठन्वी,	थानवी,	
aryma,	आर्यमा,	अर्यमा,	
varenya,	वरेनीय,	वरेण्य,	
mold,	मोल्ड,	मोल्ड,	
roosevelt,	रूजवेल्ट,	रुजवेल्ट,	
failegi,	फैलेगी,	फैलेगी,	
amadani,	अमदानी,	आमदनी,	
daisy,	दैसी,	डेजी,	
dhakelte,	धकेलते,	धकेलते,	
pakayen,	पकाएं,	पकाएं,	
songs,	सोंग्स,	सॉन्ग्स,	
belinda,	बेलिंदा,	बेलिंडा,	
ushma,	उष्मा,	ऊष्मा,	
avirl,	एवर्ल,	अविरल,	
chabutare,	चबूतारे,	चबूतरे,	
tarash,	ताराश,	तराश,	
langada,	लांगड़ा,	लंगड़ा,	
rate,	रेट,	रेट,	
reasonal,	रिजोनल,	रीजनल,	
allergic,	एलर्जिक,	एलर्जिक,	
satpal,	सत्पल,	सतपाल,	
nichaai,	निचाई,	नीचाई,	
galgand,	गलगंड,	गलगंड,	
janganna,	जांगनना,	जनगणना,	
parva,	परवा,	परवा,	
emailon,	एमैलों,	ईमेलों,	
vanon,	वनों,	वाणों,	
baramade,	बरामडे,	बरामदे,	
prapaat,	प्रपात,	प्रपात,	
danshil,	दंशील,	दानशील,	
cavity,	कैविटी,	कैविटी,	
cil,	सील,	सीआईएल,	
sarsa,	सरसा,	सरसा,	
talbagaar,	तलबागार,	तलबगार,	
dhaari,	धारी,	धारी,	
want,	वंत,	वांट,	
chachaji,	चच़ाजी,	चाचाजी,	
nitiyon,	नितियों,	नितियों,	
bayern,	बायरन,	बायर्न,	
kakoo,	काकू,	काकू,	
truth,	तृथ,	ट्रुथ,	
chidchidapan,	चिड़चिड़ापन,	चिड़चिड़ापन,	
kabr,	कबर,	कब्र,	
wadali,	वादली,	वडाली,	
kalighat,	कलीघाट,	कालीघाट,	
britain,	ब्राइटें,	ब्रिटेन,	
jataati,	जताती,	जताती,	
velvet,	वेलवेट,	वेलवेट,	
padhata,	पढ़ता,	पढ़ाता,	
granthiyan,	गृंठियां,	ग्रंथियां,	
cricketer,	क्रिकेटर,	क्रिकेटर,	
khanda,	खंडा,	खंडा,	
data,	डाता,	दाता,	
adain,	अदैन,	एडेन,	
perafin,	पेराफीन,	पैराफिन,	
urvarkon,	उर्वरकों,	उर्वरकों,	
balty,	बाल्टी,	बाल्टी,	
thaharne,	ठहराने,	ठहरने,	
corolla,	कोरोला,	कोरोला,	
aurora,	अयोरा,	औरोरा,	
agvaai,	अग्वाई,	अगवाई,	
narmi,	नर्मी,	नरमी,	
napa,	नापा,	नापा,	
tippanikar,	टिप्पणिकर,	टिप्पणीकार,	
pakshpaat,	पक्षपात,	पक्षपात,	
pahnakar,	पहनाकर,	पहनाकर,	
rapping,	रैपिंग,	रैपिंग,	
aajmaanaa,	आजमाना,	आजमाना,	
trabal,	ट्रेबल,	ट्रेबल,	
mitao,	मिटाओ,	मिटाओ,	
patkathaein,	पटकथाएं,	पटकथाएं,	
ro,	रो,	आरओ,	
prapaton,	प्रपातों,	प्रपातों,	
siyaha,	सियाह,	सियाह,	
francisca,	फ्रैंसिस्का,	फ्रांसिस्का,	
sujen,	सुजन,	सुजेन,	
mahamantr,	महामांत्र,	महामंत्र,	
ghummakkadon,	घूम्मकदाकों,	घुमक्कड़ों,	
khyber,	खीबर,	ख़ैबर,	
hounga,	हाउंगा,	होऊंगा,	
singhre,	सिंहरे,	सिंघाड़े,	
dabhra,	दाभरा,	डभरा,	
ganthen,	गंंथें,	गांठें,	
bahaav,	बहाव,	बहाव,	
mahapran,	महापराण,	महाप्राण,	
rajon,	राजों,	राजों,	
fulae,	फूलाए,	फुलाए,	
bhulaa,	भुला,	भूला,	
patavaari,	पतवारी,	पटवारी,	
maina,	मैना,	मैना,	
ladaiyon,	लड़ाइयों,	लड़ाईयों,	
celery,	सेलीरी,	सैलरी,	
jangadnaa,	जांगड़ना,	जनगणना,	
aagaashe,	आगाशे,	आगाशे,	
fawaare,	फवारे,	फव्वारे,	
badhotri,	बढ़ोत्री,	बढ़ोतरी,	
desai,	देसाई,	देसाई,	
bhadakaya,	भड़काया,	भड़काया,	
crick,	क्रिक,	क्रिक,	
dang,	डांग,	दंग,	
namkin,	नमकीन,	नमकीन,	
samprati,	संप्रति,	संप्रति,	
pahnaakar,	पहनाकर,	पहनाकर,	
el,	एल,	ऐल,	
jvaaron,	ज्वारों,	ज्वारों,	
lux,	लुक्स,	लक्स,	
vikramjit,	विक्रमिज,	विक्रमजीत,	
ilaj,	इलाज,	इलाज,	
nirbadh,	निर्बध,	निर्बाध,	
susanskrit,	सुसंस्कृत,	सुसंस्कृत,	
agha,	आघा,	आग़ा,	
bachat,	बचात,	बचत,	
pehla,	पहला,	पहला,	
sfurti,	स्फूर्ती,	स्फूर्ति,	
kamtar,	कमतार,	कमतर,	
sevai,	सेवाई,	सेंवई,	
khanikarma,	खानिकर्म,	खनिकर्म,	
haldi,	हालदी,	हल्दी,	
bhareeye,	भरीय,	भारीय,	
kaav,	काव,	काव,	
badhata,	बढ़ता,	बढ़ाता,	
martha,	मारता,	मार्था,	
rajneetikaran,	राजनीतिकरण,	राजनीतीकरण,	
kalpnaon,	कल्पनाओं,	कल्पनाओं,	
have,	हावे,	हैव,	
jealous,	जेलास,	जूलूस,	
ropaney,	रोपने,	रोपने,	
katasaraj,	कतासराज,	कटासराज,	
handiyaa,	हंदिया,	हंडिया,	
navaa,	नवा,	नवा,	
sahuuliyata,	सहूलियता,	सहूलियत,	
afroj,	अफ्रोज,	अफरोज,	
paltane,	पलतने,	पलटने,	
pml,	पीएमएल,	पीएमएल,	
font,	फॉंट,	फॉन्ट,	
chhupkr,	छुपकर,	छुपकर,	
girjagharon,	गिरजाघारों,	गिरजाघरों,	
tuth,	तूथ,	ट्रुथ,	
matthe,	मट्ठे,	मत्थे,	
ganth,	गंथ,	गांठ,	
khajraana,	खजराना,	खजराना,	
submit,	सब्मित,	सबमिट,	
puranpur,	पुरानपुर,	पूरनपुर,	
khajarana,	खजराना,	खजराना,	
chhapemar,	छापेमर,	छापेमार,	
ustara,	उस्तारा,	उस्तरा,	
mta,	एमटा,	एमटीए,	
kumau,	कुमाऊ,	कुमाऊ,	
tuglaki,	तुगलाकी,	तुगलकी,	
laurense,	लॉरेंस,	लौरेंस,	
junooni,	जुनूनी,	जुनूनी,	
jaankaron,	जानकरों,	जानकारों,	
putaliyon,	पुतालियों,	पुतलियों,	
refeli,	रेफली,	रेफेली,	
ananti,	अनांती,	अनंती,	
vigyaanon,	विज्ञानों,	विज्ञानों,	
jalbhraav,	जलभराव,	जलभराव,	
chhe,	छे,	छै,	
nelsan,	नेल्सन,	नेल्सन,	
gutta,	गुट्टा,	गुट्टा,	
douglas,	डोगलास,	डगलस,	
charcha,	चर्चा,	चर्चा,	
kshetron,	क्षेत्रों,	क्षेत्रों,	
chatunshkoniy,	चतुंकाशनीय,	चतुष्कोणीय,	
saval,	सवाल,	सवाल,	
dreijer,	ड्रेजर,	ड्रेजर,	
saraha,	सराहा,	सराहा,	
chatushkoniy,	चतुष्कानीय,	चतुष्कोणीय,	
laegi,	लाएगी,	लाएगी,	
thaki,	थाकी,	थकी,	
kpo,	कपो,	केपीओ,	
aagashe,	आगाशे,	आगाशे,	
julaahon,	जुलाहों,	जुलाहों,	
jivraj,	जीवराज,	जीवराज,	
mhantam,	महंतम,	महानतम,	
theatrs,	थेटर्स,	थियेटर्स,	
kapdi,	कपड़ी,	कापड़ी,	
chandrabali,	चंद्रबाली,	चंद्रबली,	
helper,	हेल्पर,	हेल्पर,	
francisko,	फ्रैंसिस्को,	फ्रांसिस्को,	
chaalit,	चालित,	चालित,	
gandaki,	गंदकी,	गंडकी,	
wise,	वाइज,	वाइज,	
vicharakon,	विचारकों,	विचारकों,	
aastin,	आस्तिन,	आस्तीन,	
racketeer,	रैकेटीयर,	रैकेटियर,	
agr,	अग्र,	अग्र,	
roots,	रुट्स,	रूट्स,	
mowgli,	मोगली,	मोगली,	
bhranti,	भ्रांति,	भ्रांति,	
narm,	नर्म,	नरम,	
poker,	पोकर,	पोकर,	
awaazen,	आवाजें,	आवाज़ें,	
corridor,	कॉरिडोर,	कोरिडोर,	
vaishnodevi,	वैष्णोद्वी,	वैष्णोदेवी,	
jaanch,	जांच,	जाँच,	
prabodhini,	प्रबोधिनी,	प्रबोधिनी,	
isayiyon,	ईसाईयों,	ईसाइयों,	
dhairyawan,	धैर्यवान,	धैर्यवान,	
bokaro,	बोकरो,	बोकारो,	
dhuriya,	धुरिया,	धुरिया,	
aram,	अरम,	आराम,	
vigyaani,	विज्ञानी,	विज्ञानी,	
asamanjasya,	असमंजज्या,	असामंजस्य,	
prashansanon,	प्रशंसनों,	प्रशासनों,	
ukhrool,	उखरूल,	उखरुल,	
kushan,	कुशान,	कुषाण,	
wangchuk,	वांगचुक,	वांगचुक,	
sayara,	सायरा,	सायरा,	
manae,	मनाए,	मनाए,	
mame,	मेम,	मामे,	
version,	वर्सियन,	वर्शन,	
beem,	बीम,	बीम,	
kshin,	क्षीण,	क्षीण,	
foda,	फोडा,	फोड़ा,	
calling,	कैलिंग,	कोलिंग,	
sanasthit,	सनस्थित,	संस्थित,	
prakkathan,	प्रककठन,	प्राक्कथन,	
jatak,	जाटक,	जातक,	
vidhut,	विद्युत्,	विधुत,	
lumding,	लमडिंग,	लुमडिंग,	
sudhargruh,	सुधारगृह,	सुधारगृह,	
masse,	मससे,	मस्से,	
garjana,	गर्जना,	गर्जना,	
chhudane,	छुड़ाने,	छुडाने,	
durdhara,	दुर्धारा,	दरदरा,	
naxal,	नक्सल,	नक्सल,	
shrankhalaa,	श्रृंखला,	श्रंखला,	
ramtek,	रामतेक,	रामटेक,	
daah,	दाह,	दाह,	
saturday,	सतुरदाय,	सेटरडे,	
katlary,	कतलार्य,	कटलरी,	
nava,	नवा,	नवा,	
talawe,	तलावे,	तलवे,	
multae,	मूलताए,	मुल्ताई,	
haito,	हैटो,	हैतो,	
vartmaan,	वर्तमान,	वर्तमान,	
moody,	मूद्य,	मूडी,	
dubona,	डुबोना,	डुबोना,	
badhati,	बढ़ती,	बढ़ाती,	
enthe,	ऐंठे,	ऐंठे,	
jajaon,	जाजाओं,	जजों,	
ishaaq,	इशाक,	इशाक,	
shelling,	शेलिंग,	शेलिंग,	
tungnath,	तूंगनाथ,	तुंगनाथ,	
ot,	ओट,	ओत,	
robin,	रॉबीन,	रोबिन,	
panchaang,	पंचांग,	पंचांग,	
ludhakate,	लुढ़कते,	लुढ़कते,	
khene,	खेने,	खेने,	
maule,	मौले,	मौले,	
bharne,	भरने,	भरने,	
proof,	प्रूफ,	प्रूफ,	
mejbaani,	मेजबानी,	मेजबानी,	
pic,	पिक,	पिक,	
eksath,	एकसाथ,	एकसाथ,	
ghataatop,	घटातोप,	घटाटोप,	
propellant,	प्रोपलेंट,	प्रोपेलेंट,	
hani,	हानी,	हानी,	
aanad,	आनाद,	आनद,	
janjagran,	जनजागरन,	जनजागरण,	
kasarat,	कसरत,	कसरत,	
choro,	चोरो,	चोरों,	
kanthahar,	कंठहर,	कंठहार,	
dhokebaaj,	धोकेबाज,	धोखेबाज,	
pihaani,	पीहानी,	पिहानी,	
virechan,	विरेचन,	विरेचन,	
ruganta,	रुगांता,	रुग्णता,	
stain,	स्टेन,	स्टैन,	
khurapka,	खुरपका,	खुरपका,	
bahav,	बहव,	बहाव,	
vajud,	वाजुद,	वजूद,	
bhartnatyam,	भर्तनाट्म,	भरतनाट्यम्,	
chhagan,	छगन,	छगन,	
baadhit,	बाधित,	बाधित,	
manmarji,	मनमर्जी,	मनमर्जी,	
liidaron,	लिदारों,	लीडरों,	
rahenge,	रहेंगे,	रहेंगे,	
auchity,	ऑचिती,	औचित्य,	
gujarana,	गुजरना,	गुजारना,	
achhi,	अछी,	अच्छी,	
jyotiba,	ज्योतिबा,	ज्योतिबा,	
sanasthita,	सनस्थिता,	संस्थिता,	
yariyan,	यारियां,	यारियां,	
supachye,	सुपच्य,	सुपाच्य,	
als,	एल्स,	एएलएस,	
marwar,	मरवार,	मारवाड़,	
juti,	जूटी,	जुटी,	
risne,	रिसने,	रिसने,	
barsaataa,	बरसाता,	बरसाता,	
devi,	देवी,	डेवी,	
shakir,	शाकिर,	शाकिर,	
hemwati,	हेमवती,	हेमवती,	
prapat,	प्रपात,	प्रपात,	
pehno,	पहनो,	पहनो,	
manipal,	मनिपाल,	मणिपाल,	
sweep,	स्वीप,	स्वीप,	
paarshad,	पारशाद,	पार्षद,	
pale,	पाले,	पले,	
samprabhuta,	संप्रभूत,	संप्रभुता,	
arjent,	अर्जेंट,	अर्जेंट,	
pmo,	पीएम,	पीएमओ,	
muhavre,	मुहावरे,	मुहावरे,	
bombi,	बोंबी,	बांबी,	
dangerous,	डैंगररस,	डेंजरस,	
made,	मेड,	मैड,	
sabhaein,	सभाएं,	सभाएं,	
riggs,	रिग्स,	रिग्स,	
ranjkatha,	रणंकाठा,	रंजकता,	
ditaa,	दिता,	दिता,	
diphtheria,	दिप्ठेरीय,	डिप्थीरिया,	
routine,	राउटिन,	रूटिंग,	
chowk,	चोक,	चौक,	
aawajen,	आवाजें,	आवाज़ें,	
darmiyaan,	दरमियां,	दरमियान,	
girati,	गिरती,	गिरती,	
gtor,	ग्टोर,	जीतोड़,	
putle,	पुटले,	पुतले,	
chillane,	चिल्नाने,	चिल्लाने,	
prathmiki,	प्राथमिकी,	प्राथमिकी,	
varna,	वर्ना,	वर्ण,	
priyamani,	प्रियमणी,	प्रियामणि,	
bavji,	बावजी,	बावजी,	
chrome,	क्रोम,	क्रोम,	
kiratpur,	किरतपुर,	कीरतपुर,	
vershan,	वर्षन,	वर्शन,	
hathiya,	हथिया,	हथिया,	
pehnate,	पहनते,	पहनते,	
tankaar,	टंकार,	टंकार,	
raubadaar,	राउबादार,	रौबदार,	
tarafa,	तरफा,	तरफा,	
help,	हेल्प,	हेल्प,	
jayalalithaa,	जयालालीता,	जयललिता,	
toh,	तोह,	तो,	
lagnevaaley,	लगनेवाले,	लगनेवाले,	
jodiyon,	जोड़ियों,	जोड़ियों,	
vibram,	विब्रम,	विभ्रम,	
samoaa,	समोआ,	सामोआ,	
vigyani,	विज्ञानी,	विज्ञानी,	
francisco,	फ्रैंसिस्को,	फ्रांसिस्को,	
stanadhari,	स्तनाधारी,	स्तनधारी,	
radical,	रेडिकल,	रैडिकल,	
scaining,	स्केनिंग,	स्कैनिंग,	
paratrooper,	पारतपूर,	पैराट्रूपर,	
padegaa,	पदेगा,	पड़ेगा,	
baapaa,	बापा,	बापा,	
farmion,	फर्मियन,	फर्मिऑन,	
phus,	फूस,	फूस,	
isteefe,	इस्तेफे,	इस्तीफे,	
bimon,	बीमों,	बीमों,	
kabra,	कबरा,	कब्र,	
kalamjeet,	कलमजीत,	कमलजीत,	
vediyon,	वेदियों,	वेदियों,	
raagon,	रागों,	रागों,	
mogali,	मोगली,	मोगली,	
classon,	क्लासों,	क्लासों,	
pummy,	पम्मी,	पम्मी,	
amod,	अमोद,	आमोद,	
sudhargrih,	सुधारगृह,	सुधारगृह,	
ropane,	रोपने,	रोपने,	
nubiya,	नुबिया,	नूबिया,	
james,	जमेस,	जेम्स,	
samanvayaka,	समन्वयका,	समन्वयक,	
kajoo,	काजू,	काजू,	
chune,	चुने,	चुने,	
nun,	नन,	नून,	
aarya,	आर्य,	आर्य,	
narsanhar,	नरसंहार,	नरसंहार,	
asset,	एसेट,	असेट,	
gosvami,	गोस्वामी,	गोस्वामी,	
mayorkaa,	मयोरका,	मयोर्का,	
january,	जननूरी,	जनवरी,	
diya,	दिया,	दीया,	
labeling,	लेबेलिंग,	लेबलिंग,	
erica,	एरिका,	एरिका,	
hundiya,	हंडिया,	हंडिया,	
siera,	सियरा,	सिएरा,	
skootaron,	स्कूतरों,	स्कूटरों,	
sipaha,	सिपाहा,	सिपाह,	
prativadi,	प्रतिवादी,	प्रतिवादी,	
bechakar,	बेचाकर,	बेचकर,	
neelaabh,	नीलाभ,	नीलाभ,	
shrungar,	श्रुंगार,	शृंगार,	
garibi,	गरीबी,	गरीबी,	
chhaviyan,	छावियां,	छवियाँ,	
bagd,	बैगड़,	बगड़,	
generat,	जनरेट,	जेनरेट,	
dikhaaee,	दिखाई,	दिखाईं,	
sahadev,	सहदेव,	सहदेव,	
ehsaas,	एहसास,	एहसास,	
killat,	किल्लत,	किल्लत,	
vaisaakh,	वैसाख,	वैशाख,	
samjhungaa,	समझुगा,	समझूंगा,	
bandhati,	बांधती,	बंधती,	
pailoton,	पैलोटों,	पायलटों,	
bhrantiyan,	भ्रंटियां,	भ्रांतियां,	
brigatn,	ब्राइटन,	ब्रिगटन,	
chaudah,	चौदह,	चौड़ा,	
navanagar,	नवानगर,	नवानगर,	
mtake,	मटेक,	एमटेक,	
nichalaa,	निचला,	निचला,	
gumaan,	गुमान,	गुमान,	
namo,	नमो,	नामो,	
standhaari,	स्तनधारी,	स्तनधारी,	
paim,	पैम,	पैम,	
chaudhavan,	चौदहवन,	चौदहवां,	
item,	इटेम,	आइटम,	
masaledar,	मसालेदार,	मसालेदार,	
iaan,	आईएन,	इआन,	
dikhai,	दिखाई,	दिखार्इ,	
dukanon,	दुकानों,	दुकानों,	
posta,	पोस्ता,	पोस्ता,	
urgent,	उर्जेंट,	अर्जेंट,	
dridh,	दृध,	दृढ़,	
purvabhas,	पूर्वाभास,	पूर्वाभास,	
manto,	मांटो,	मंटो,	
vaishakh,	वैशाख,	वैशाख,	
langda,	लांगड़ा,	लंगड़ा,	
uttra,	उत्तरा,	उत्तरा,	
kaasht,	काष्ट,	काश्त,	
batlae,	बतलाए,	बतलाए,	
maharaja,	महाराजा,	महाराजा,	
kurmi,	कुर्मी,	कुर्मी,	
quete,	क्वेट,	क्यूट,	
mehamaan,	मेहमान,	मेहमान,	
reeta,	रीता,	रीता,	
dubaana,	दुबाना,	डुबाना,	
bharate,	भराते,	भरते,	
janhani,	जान्हानी,	जनहानि,	
badhaaon,	बढ़ाओं,	बाधाओं,	
hasinon,	हसीनों,	हसीनों,	
kritika,	कृतिका,	कृतिका,	
pahnata,	पहनता,	पहनता,	
nano,	नानो,	नैनो,	
rounder,	राउंडर,	राउंडर,	
tarch,	तर्च,	टार्च,	
pide,	पीढ़,	पाइड,	
bag,	बाग,	बीएजी,	
adaani,	अदानी,	अदाणी,	
karyarat,	कार्यारत,	कार्यरत,	
chikhali,	चिखली,	चिखली,	
upneta,	उपनेता,	उपनेता,	
sametti,	समेट्टी,	समेटती,	
haraval,	हरावाल,	हरावल,	
haan,	हान,	हां,	
taja,	ताजा,	ताजा,	
kav,	काव,	काव,	
isht,	इष्ट,	इष्ट,	
kurvi,	कुर्वी,	कर्वी,	
visheshanon,	विशेषनों,	विशेषणों,	
gomukh,	गोमुख,	गौमुख,	
brocken,	ब्रॉकेन,	ब्रोकन,	
muhavare,	मुहावरे,	मुहावरे,	
divyata,	दिव्यता,	दिव्यता,	
dardara,	दरदारा,	दरदरा,	
hault,	हॉल्ट,	हाल्ट,	
tired,	टायर्ड,	टायर्ड,	
peratrupers,	पैराटरपार्स,	पैराट्रूपर,	
baabat,	बाबत,	बाबत,	
torch,	तॉर्च,	टार्च,	
sudhaargrah,	सुधारगृह,	सुधारगृह,	
angkor,	अंगकोर,	अंकोर,	
alnkaar,	अलंकार,	अलंकार,	
praudh,	प्रौढ़,	प्रौढ,	
premlata,	प्रेमला,	प्रेमलता,	
saajsajja,	साजसजजा,	साजसज्जा,	
barahamasi,	बरहमासी,	बारहमासी,	
ghumakkaron,	घुमककरों,	घुमक्कड़ों,	
mancheeye,	मंचीय,	मंचीय,	
semin,	सेमिन,	सेमिन,	
shaavakon,	शावकों,	शावकों,	
wlaad,	व्लाड,	व्लाद,	
fodo,	फोडो,	फोड़ों,	
aalochakon,	आलोचकों,	आलोचकों,	
cadmium,	कैडमियम,	कैडमियम,	
hingis,	हिंगिस,	हिंगिस,	
visheshan,	विशेषन,	विशेषण,	
thumri,	थुमरी,	ठुमरी,	
fulay,	फुला,	फुलाए,	
abantit,	अबंतित,	आबंटित,	
sitaram,	सीतारम,	सीताराम,	
rojvelt,	रोजवेल्ट,	रुजवेल्ट,	
dewey,	देवी,	डेवी,	
takravon,	टकरावों,	टकरावों,	
hoshangabad,	होशनगाबाद,	होशंगाबाद,	
kumawat,	कुमावत,	कुमावत,	
bavaji,	बावाजी,	बावजी,	
virchand,	विरचंद,	वीरचंद,	
nadsa,	नडसा,	नक्सल,	
jinee,	जीनी,	जिनी,	
punjikaran,	पुंजीकरण,	पूंजीकरण,	
aadhunik,	आधुनिक,	आधुनिक,	
chhahon,	छाहों,	छहों,	
mason,	मसों,	मासों,	
gujara,	गुजरा,	गुजारा,	
signals,	सिगलन्स,	सिगनल्स,	
prativad,	प्रतिवाद,	प्रतिवाद,	
raajasva,	राजस्व,	राजस्व,	
laingikta,	लैंगिकता,	लैंगिकता,	
skhalan,	स्खलन,	स्खलन,	
vaimanasya,	वैमानस्य,	वैमनस्य,	
plus,	प्लस,	पल्स,	
medical,	मैडिकल,	मेडीकल,	
sapatey,	सपते,	सपाटे,	
aarushi,	आरूषि,	आरुषि,	
bhaya,	भाया,	भय,	
dardraa,	दर्दरा,	दरदरा,	
dikhai,	दिखाई,	दिखायी,	
langdon,	लांगड़ों,	लैंगडन,	
huppar,	हुप्र,	हूपर,	
bhulata,	भुलता,	भूलता,	
char,	चार,	चार,	
parishadiya,	परिशादिय,	परिषदीय,	
nirbaadh,	निरबबध,	निर्बाध,	
putli,	पुत्ली,	पुतली,	
bhavishya,	भविष्य,	भविष्य,	
toka,	टोका,	टोका,	
amargarh,	अमरगाढ़,	अमरगढ़,	
swarthparak,	स्वार्थपारक,	स्वार्थपरक,	
shantikal,	शांतिकाल,	शांतिकाल,	
jay,	जाय,	जय,	
chadhane,	चढ़ने,	चढ़ने,	
bhengapan,	भेंगापन,	भेंगापन,	
abbasi,	अब्बासी,	अब्बासी,	
durghtna,	दुर्घटना,	दुर्घटना,	
tambe,	तंबे,	तांबे,	
purjon,	पुर्जों,	पुर्जों,	
canals,	कैनल्स,	कनाल,	
maang,	मांग,	मांग,	
sevkon,	सेवकों,	सेवकों,	
propellent,	प्रोपलेंट,	प्रोपेलेंट,	
vishwasaniy,	विश्वासनीय,	विश्वसनीय,	
achchi,	अच्छी,	अच्छी,	
mehmaan,	मेहमान,	मेहमान,	
mayorka,	मयोरका,	मयोर्का,	
ratrichar,	रत्रिचार,	रात्रिचर,	
fransisko,	फ्रांसिसको,	फ्रांसिस्को,	
rudolph,	रूडोल्फ,	रुडोल्फ,	
urdhav,	उर्धव,	ऊर्ध्व,	
apaardarshi,	अपरदर्शी,	अपारदर्शी,	
langron,	लांगड़ों,	लंगरों,	
jatiyon,	जातियों,	जातियों,	
naamo,	नामो,	नामो,	
barah,	बारह,	बारह,	
sohrai,	सोहराई,	सोहराई,	
yashpal,	यशपाल,	यशपाल,	
davey,	दवे,	डेवी,	
nilgai,	निलगाई,	नीलगाय,	
kaji,	काजी,	काजी,	
bhraantiyon,	भ्रांतियों,	भ्रांतियों,	
phodo,	फोडो,	फोड़ों,	
men,	मेन,	मैन,	
naukri,	नौकरी,	नोकरी,	
sanchar,	संचार,	संचार,	
andrabee,	अंदराबी,	अंद्राबी,	
bikaner,	बिकनर,	बीकानेर,	
mushahid,	मुशाहिद,	मुशाहिद,	
isht,	इष्ट,	ईष्ट,	
uthapatak,	उठापातक,	उठापटक,	
frost,	फ्रोस्ट,	फ्रॉस्ट,	
audhyogikaran,	औध्योगिकरण,	औद्योगिकरण,	
beef,	बीफ,	बीफ,	
dikhayi,	दिखाई,	दिखार्इ,	
edan,	एडन,	एडेन,	
solitaire,	सोलीटेयर,	सोलिटेयर,	
nehara,	नेहरा,	नेहरा,	
tarkwaad,	तरकवाड़,	तर्कवाद,	
nitrous,	नाइट्रॉस,	नाइट्रस,	
sneakers,	स्नीकर्स,	स्नीकर्स,	
dhanadhany,	धनाधान्य,	धनधान्य,	
avegyanik,	अव्यगनानिक,	अवैज्ञानिक,	
gtod,	गटोड,	जीतोड़,	
maap,	माप,	माप,	
reshe,	रेशे,	रेशे,	
bago,	बागो,	बागो,	
yatna,	यतना,	यत्न,	
chhure,	छुरे,	छुरे,	
complex,	कॉपलेक्स,	कॉम्प्लेक्स,	
urwarakon,	उर्वरकों,	उर्वरकों,	
mardo,	मरदो,	मर्दों,	
chanval,	चांवल,	चांवल,	
farhin,	फरहीन,	फरहीन,	
paheliyaan,	पहेलियां,	पहेलियां,	
pakshapat,	पक्षापत,	पक्षपात,	
zuban,	जुबान,	ज़ुबान,	
byaawa,	ब्याव,	ब्यावर,	
dinank,	दिनांक,	दिनांक,	
shaakhaaen,	शाखाएं,	शाखाएं,	
kanyaein,	कन्याएं,	कन्याएं,	
usak,	उसक,	उसक,	
jhankna,	झांकना,	झांकना,	
kasida,	कसीदा,	कसीदा,	
chitthi,	चिट्ठी,	चिट्ठी,	
bnaam,	बनाम,	बनाम,	
bodraa,	बोद्रा,	बोदरा,	
deepan,	दीपन,	दीपन,	
mahlon,	महलों,	महलों,	
pushpaa,	पुष्प,	पुष्पा,	
avshisht,	अवशिष्ट,	अवशिष्ट,	
sanskaar,	संस्कार,	संस्कार,	
fermion,	फर्मियन,	फर्मिऑन,	
roomani,	रूमानी,	रुमानी,	
kural,	कुराल,	कुराल,	
salaahkar,	सलाहकर,	सलाहकार,	
ganthe,	गंथे,	गांठे,	
bakaul,	बकैल,	बकौल,	
shujaat,	शुजात,	शुजात,	
ghumakkdi,	घुमकककी,	घुमक्कड़ी,	
vitark,	वितरक,	वितर्क,	
darra,	डर्रा,	दर्रा,	
registani,	रेजिस्तानी,	रेगिस्तानी,	
dinosaur,	दिनोसौर,	डायनासोर,	
phalibhoot,	फलीभूत,	फलीभूत,	
tenis,	टेनिस,	टेनिस,	
pengolin,	पेंगोलिन,	पैंगोलिन,	
niptara,	निपटारा,	निपटारा,	
punter,	पंटर,	पंटर,	
programers,	प्रोग्रामर्स,	प्रोग्रामर्स,	
fandon,	फांडों,	फंदों,	
baramde,	बरामडे,	बरामदे,	
rajkot,	राजकोट,	राजकोट,	
farmic,	फार्मिक,	फार्मिक,	
mahapauron,	महापौरों,	महापौरों,	
drupad,	द्रुपद,	ध्रुपद,	
rasayanon,	रसायनों,	रसायनों,	
pharma,	फर्मा,	फार्मों,	
rambharose,	रामभारोस,	रामभरोसे,	
kap,	कप,	कप,	
joint,	जॉइंट,	ज्वाइंट,	
neto,	नीटो,	नेटो,	
trimasik,	त्रिमासिक,	त्रैमासिक,	
barsa,	बरसा,	बरसा,	
vaishakhi,	वैशाखी,	वैशाखी,	
jatra,	जातरा,	जतरा,	
julahon,	जुलाहों,	जुलाहों,	
bhaunhon,	भौनोहों,	भौंहों,	
shararat,	शरारत,	शरारत,	
shetron,	क्षेत्रों,	क्षेत्रों,	
rectare,	रिक्टेयर,	रैकेटियर,	
soya,	सोया,	सोया,	
labada,	लबादा,	लबादा,	
bapaa,	बापा,	बापा,	
fatama,	फतामा,	फातमा,	
failaiye,	फैलाइए,	फैलाइए,	
adhik,	अधिक,	अधीक,	
asharaphi,	अशराफी,	अशरफी,	
apavartit,	अपवर्तित,	अपवर्तित,	
ropne,	रोपने,	रोपने,	
nokari,	नोकरी,	नोकरी,	
niveshkartaa,	निवेषकर्ता,	निवेशकर्ता,	
najariyon,	नजरियों,	नजरियों,	
yugm,	युग्म,	युग्म,	
pidiya,	पीढ़िया,	पीडिया,	
jhalla,	झल्ला,	झल्ला,	
jini,	जीनी,	जिनी,	
parwaa,	परवा,	परवा,	
chitrkar,	चित्रकार,	चित्रकार,	
achambha,	अचंभा,	अचंभा,	
pummi,	पुम्मी,	पम्मी,	
masoor,	मसूर,	मसूर,	
taraash,	तराश,	तराश,	
padega,	पदेगा,	पड़ेगा,	
bamba,	बांबा,	बंबा,	
surveen,	सुरवीन,	सुरवीन,	
sarsaa,	सरसा,	सरसा,	
ankor,	अंकोर,	अंकोर,	
dazy,	देज्य,	डेजी,	
daakhil,	दाखिल,	दाखिल,	
amanth,	अमांत,	अमानत,	
dikhai,	दिखाई,	दिखाईं,	
augusta,	अगुस्त,	अगस्ता,	
mooth,	मूठ,	मूठ,	
jin,	जीन,	जीन,	
pruf,	प्रुफ,	प्रूफ,	
sthitiyaan,	स्थितियां,	स्थितियां,	
maurya,	मौर्य,	मौर्या,	
udan,	उदान,	उड़ान,	
suneeti,	सुनीती,	सुनीति,	
seth,	सेठ,	सेथ,	
sajan,	सजन,	साजन,	
bhav,	भाव,	बहाव,	
thengaa,	ठेंगा,	ठेंगा,	
harawal,	हरावाल,	हरावल,	
augustine,	अगस्टीसन,	अगस्टाइन,	
tarko,	तरको,	तर्कों,	
narayangadh,	नारायंगढ़,	नारायणगढ़,	
bhootal,	भूताल,	भूतल,	
kankad,	कांकड़,	कंकड़,	
jaddit,	जड़दित,	जड़ित,	
tirthatan,	तीर्थन,	तीर्थाटन,	
kanyayen,	कन्याएं,	कन्याएं,	
live,	लाइव,	लाईव,	
uda,	उड़ा,	उदा,	
recer,	रेसर,	रेसर,	
shumali,	शुमाली,	शुमाली,	
bhoonhon,	भूनों,	भौंहों,	
kisaani,	किसनी,	किसानी,	
faisala,	फैसला,	फ़ैसला,	
bahamaas,	बहमास,	बहामास,	
catlin,	कैटलिन,	कैटलिन,	
durgun,	दुर्गुण,	दुर्गुण,	
suniti,	सुनीती,	सुनीति,	
alnkaaron,	अलंकारों,	अलंकारों,	
sikud,	सिकुड़,	सिकुड़,	
baithate,	बैठते,	बैठते,	
putliyan,	पुत्लियां,	पुतलियां,	
nehra,	नहरा,	नेहरा,	
saraaha,	सराहा,	सराहा,	
raadhe,	राधे,	राधे,	
thailee,	थैली,	थैली,	
sweccha,	स्वेच्छ,	स्वेच्छा,	
talbagar,	तलबागार,	तलबगार,	
colan,	कोलन,	कोलन,	
wade,	वेड,	वेड,	
swiftlate,	स्विफ्टलेट,	स्विफ्टलेट,	
aerobics,	एयरोबिक्स,	एरोबिक,	
laganewale,	लगानेवाले,	लगनेवाले,	
dark,	डार्क,	डॉर्क,	
kamjor,	कमजोर,	कमज़ोर,	
earthquake,	आर्थकेक,	अर्थक्वेक,	
rak,	रक,	राक,	
shayak,	शायक,	शायक,	
dhundhata,	ढूंढता,	ढूंढता,	
dhamma,	धम्मा,	धम्मा,	
nishnaat,	निश्नात,	निष्णात,	
dhande,	ढांडे,	धंधे,	
chadar,	चादर,	चादर,	
hilne,	हिलने,	हिलने,	
polimer,	पॉलीमर,	पॉलिमर,	
vipra,	विप्र,	विप्रा,	
devidson,	डेविड्सन,	डेविडसन,	
umanath,	उमानाथ,	उमानाथ,	
farms,	फर्म्स,	फार्म्स,	
eater,	ईटर,	ईटर,	
sanyojanon,	संयोजनों,	संयोजनों,	
matsyendranath,	मत्स्येर्णधार्थ,	मत्स्येंद्रनाथ,	
taiboo,	टैबू,	टैबू,	
sargana,	सरगना,	सरगना,	
jubair,	जुबैर,	जुबेर,	
flynn,	फ्लान,	फ्लिन,	
paradhin,	पराधीन,	पराधीन,	
nora,	नोरा,	नोरा,	
ajit,	अजीत,	अजित,	
theaters,	थीटर्स,	थियेटर्स,	
abvp,	एबीवीपी,	एबीवीपी,	
vigyan,	विज्ञान,	विज्ञान,	
vaanon,	वानों,	वाणों,	
gaya,	गाया,	गया,	
humlavar,	हमलावर,	हमलावर,	
shaantikaal,	शांतिकाल,	शांतिकाल,	
pastry,	पास्ट्री,	पेस्ट्री,	
trott,	ट्रॉट,	ट्रॉट,	
bramad,	ब्रमाद,	बरामद,	
jeen,	जीन,	जिन,	
udakishuganj,	उदाकिशुगंज,	उदाकिशुनगंज,	
sunasir,	सुनासिर,	सुनासीर,	
mop,	मॉप,	माप,	
programs,	प्रोग्राम्स,	प्रोग्रामर्स,	
gadadhar,	गदाधार,	गदाधर,	
candidate,	कैंडीडेट,	कैंडिडेट,	
bowling,	बोलिंग,	बाउलिंग,	
chhavi,	छावी,	छवी,	
taapti,	तापती,	ताप्ती,	
damoh,	दामोह,	दमोह,	
chaktte,	चक्तते,	चकत्ते,	
proto,	प्रोटो,	प्रोटो,	
shmadan,	श्मदान,	शमादान,	
vyavdhan,	व्यवधान,	व्यवधान,	
datsun,	दत्सून,	डैटसन,	
bagbani,	बागबानी,	बागबानी,	
shaili,	शैली,	शैली,	
kahane,	कहाने,	कहने,	
kakkar,	कक्कर,	कक्कड़,	
sheli,	शेली,	शैली,	
varsaryache,	वर्रायराच,	वर्साचे,	
ulahana,	उलाहाना,	उलाहना,	
bechte,	बेचते,	बेचते,	
jing,	जिंग,	जिंग,	
ruby,	रूबी,	रुबी,	
kutta,	कुट्टा,	कुत्ता,	
herald,	हेराल्ड,	हैराल्ड,	
duwaidhaayein,	दुवैधाएं,	दुविधाएं,	
mhavidya,	महाविद्य,	महाविद्या,	
thenga,	ठेंगा,	ठेंगा,	
chhinky,	छीनकी,	छींके,	
registered,	रेजिस्टेरेड,	रजिस्टर्ड,	
beesavaan,	बीसवां,	बीसवां,	
sapaat,	सपात,	सपाट,	
wayna,	वायना,	वायना,	
hindan,	हिंदन,	हिंडन,	
ulate,	उलते,	उलटे,	
jwar,	ज्वर,	ज्वार,	
pashtuun,	पश्तुओं,	पश्तून,	
anishwarvadi,	अनिश्वारवादी,	अनीश्वरवादी,	
anhoni,	अन्होंनी,	अनहोनी,	
christian,	क्रिस्टियन,	क्रिश्चयन,	
dikhlaa,	दिखला,	दिखला,	
cigretton,	सिग्रेटन,	सिगरेटों,	
maulvidon,	मौलविदों,	मौलवियों,	
sanjeevan,	संजीवन,	संजीवन,	
imaging,	इमैजिंग,	इमेजिंग,	
pagalaa,	पगला,	पगला,	
ghontane,	घोंटने,	घोंटने,	
arpit,	आर्पिट,	अर्पित,	
bhogatey,	भोगते,	भोगते,	
uthne,	उठने,	उठने,	
farse,	फार्स,	फरसे,	
manjilen,	मंजीलें,	मंजिलें,	
bhugata,	भुगता,	भुगता,	
lata,	लाता,	लाता,	
sean,	सिन,	शॉन,	
bhagaane,	भगाने,	भगाने,	
davidson,	देविद्सों,	डेविडसन,	
grandson,	ग्रांडसों,	ग्रैंडसन,	
duneerti,	दुनीरती,	दुर्नीति,	
chauka,	चौका,	चौका,	
siddhwat,	सिद्धवत,	सिद्धवट,	
chunar,	चुनार,	चूनर,	
sanjivan,	संजीवन,	संजीवन,	
feeder,	फीडर,	फीडर,	
ghumakkdon,	घुमककदों,	घुमक्कड़ों,	
standhari,	स्तनधारी,	स्तनधारी,	
vyavahargat,	व्यवहार्गत,	व्यवहारगत,	
bakuu,	बकु,	बाकू,	
tse,	ट्से,	त्से,	
sametati,	समेटती,	समेटती,	
sulzai,	सुलझाई,	सुलझाई,	
pushpon,	पुष्पों,	पुष्पों,	
udanon,	उदानों,	उड़ानों,	
haqeeqat,	हकीकत,	हकीकत,	
ghumakkadon,	घुमककादों,	घुमक्कड़ों,	
narsanharon,	नरसंहारों,	नरसंहारों,	
depthiriya,	देप्थिरीय,	डिप्थीरिया,	
aryo,	आर्यो,	आर्यो,	
kapadi,	कपड़ी,	कापड़ी,	
jewellers,	जेवलर्स,	ज्वेलर्स,	
dhkelate,	ढकेलेते,	धकेलते,	
raaj,	राज,	राज,	
duak,	डुक,	ड्यूक,	
afroz,	अफ्रोज,	अफरोज,	
ghabrahat,	घबराहट,	घबराहट,	
sakar,	साकार,	सॉकर,	
ginate,	गिनते,	गिनते,	
namankano,	नमानकनों,	नामांकनों,	
triya,	ट्रिया,	त्रिया,	
muller,	म्यूलर,	मूलर,	
gyapit,	ज्ञापित,	ज्ञापित,	
artery,	आर्टरी,	आर्टरी,	
vidyaaon,	विद्याओं,	विद्याओं,	
suiyan,	सुईयान,	सूइयां,	
pik,	पीक,	पिक,	
utane,	उताने,	उतने,	
bhugol,	भूगोल,	भूगोल,	
pahan,	पहन,	पहन,	
kapda,	कपड़ा,	कपड़ा,	
sayan,	सायन,	सायं,	
avsthayen,	अवस्थाएं,	अवस्थाएं,	
aamod,	आमोद,	आमोद,	
augustustine,	अगस्टस्टाइन,	अगस्टाइन,	
beaulad,	बेयुल्ड,	बेऔलाद,	
acapulco,	अकापल्क,	अकापुल्को,	
favvaron,	फववारों,	फव्वारों,	
ea,	ईए,	ईए,	
quebec,	क्यूबेक,	क्यूबेक,	
rakhna,	रखना,	रखना,	
mhathir,	महाठिर,	महाथिर,	
bharani,	भरनी,	भरनी,	
bhadkaayaa,	भड़काया,	भड़काया,	
raajneetikaran,	राजनीतिकरण,	राजनीतीकरण,	
mantriyon,	मंत्रियों,	मंत्रियों,	
bhagane,	भगाने,	भगाने,	
padhaa,	पढ़ा,	पढ़ा,	
shaly,	शाल्य,	शैली,	
madhura,	मधुरा,	मढ़ौरा,	
sfc,	एसएफसी,	एसएफसी,	
janganana,	जांगनना,	जनगणना,	
kamaljeet,	कमलजीत,	कमलजीत,	
naksal,	नकसाल,	नक्सल,	
najriyon,	नज़रियों,	नजरियों,	
ghuman,	घूमान,	घुमाण,	
yda,	एडा,	यदा,	
updraviyon,	उप्रवाियों,	उपद्रवियों,	
phadphadata,	फड़फड़ता,	फड़फड़ाता,	
changul,	चंगुल,	चंगुल,	
rojlin,	रोजलीन,	रोजलिन,	
funding,	फंडिंग,	फंडिंग,	
nipatara,	निपटारा,	निपटारा,	
jeeyo,	जीयो,	जीयो,	
thki,	थकी,	थकी,	
lootmaar,	लूटमार,	लूटमार,	
jasmit,	जसममित,	जसमीत,	
venkataraman,	वेंकटरमण,	वेंकटरमन,	
vividh,	विविध,	विविध,	
rayan,	रायन,	रयान,	
mangni,	मंगनी,	मांगनी,	
badha,	बढ़ा,	बाधा,	
ayodhyanaath,	अयोध्यनाथ,	अयोध्यानाथ,	
khatakti,	खटकती,	खटकती,	
bharane,	भरने,	भरने,	
ata,	अता,	आटा,	
dhokhebaj,	धोखेबाज,	धोखेबाज,	
haanfte,	हांफते,	हांफते,	
package,	पैकेज,	पैकेज,	
katrina,	कतरीन,	कैटरीना,	
bapa,	बापा,	बापा,	
vyapak,	व्यापक,	व्यापक,	
formic,	फॉर्मिक,	फार्मिक,	
kailana,	कैलाना,	कायलाना,	
jalte,	जलते,	जलते,	
dhiryawaan,	धिर्यवान,	धैर्यवान,	
chaukiyan,	चौकियां,	चौकियां,	
punargathan,	पुनर्गाठन,	पुनर्गठन,	
nrutyashaili,	नृत्यशाली,	नृत्यशैली,	
dhokhebaaj,	धोखेबाज,	धोखेबाज,	
tuglak,	तुगलक,	तुगलक,	
anudit,	अनुदित,	अनूदित,	
chanwal,	चांवल,	चांवल,	
jacks,	जैक्स,	जैक्स,	
nasim,	नसीम,	नसीम,	
kagaz,	कागज़,	कागज़,	
dyeyvadi,	द्याववादी,	ध्येयवादी,	
holding,	होल्डिंग,	होल्डिंग,	
vartman,	वर्तमान,	वर्तमान,	
katlari,	कत्लारी,	कटलरी,	
matrix,	मैट्रिक्स,	मैट्रिक्स,	
viresh,	विरेश,	वीरेश,	
attahasa,	अत्थासा,	अट्टहास,	
sonpne,	सोनपने,	सौंपने,	
chaupal,	चौपल,	चौपाल,	
bim,	बीम,	बीम,	
bheesham,	भीष्म,	भीष्म,	
saptakranti,	सप्तक्रांति,	सप्तक्रांति,	
parabola,	परबोला,	पैराबोला,	
vimarsho,	विमर्शो,	विमर्शों,	
amavsya,	अमावस्य,	अमावस्या,	
khanik,	खनिक,	खनिक,	
sahab,	सहाब,	साहब,	
vanshavad,	वंशावाद,	वंशवाद,	
yatna,	यतना,	यातना,	
hooper,	हापर,	हूपर,	
jhalakti,	झलकती,	झलकती,	
synapse,	सिनेप्स,	सिनेप्स,	
half,	हालफ,	हॉफ,	
dahan,	दहन,	दहन,	
baahulya,	बहुल्य,	बाहुल्य,	
enth,	ऐंथ,	ऐंठ,	
sanchaari,	संचारी,	संचारी,	
rosariyo,	रोसरियों,	रोसारियो,	
samalakha,	समलाखा,	समालखा,	
dikhayin,	दिखाएं,	दिखाईं,	
prashaasanik,	प्रशासानिक,	प्रशासनिक,	
pahnaati,	पहनाती,	पहनाती,	
strocks,	स्ट्रॉक्स,	स्ट्रोक्स,	
harijan,	हरिजन,	हरिजन,	
tonic,	टोनिक,	टॉनिक,	
pahla,	पहला,	पहला,	
ukranian,	उक्राणियन,	यूक्रेनियन,	
kahlaya,	कहलाया,	कहलाया,	
deepika,	दीपिका,	दीपिका,	
jockey,	जॉकी,	जोकि,	
dhamkata,	धमकता,	धमकाता,	
tarkvad,	तरकवाद,	तर्कवाद,	
samjhunga,	समझुगा,	समझूंगा,	
sahdev,	सहदेव,	सहदेव,	
aawaazen,	आवाजें,	आवाज़ें,	
jgayegaa,	जगाएगा,	जगाएगा,	
jin,	जीन,	जिन,	
racketier,	रैकेटीयर,	रैकेटियर,	
putul,	पुतुल,	पुतुल,	
bhulta,	भुलता,	भूलता,	
kiya,	किया,	किया,	
dhaaga,	धागा,	धागा,	
dikhaiye,	दिखाइए,	दिखाइये,	
shumaali,	शुमाली,	शुमाली,	
mehman,	महहमान,	मेहमान,	
jivant,	जीवंत,	जीवंत,	
jutee,	जूती,	जुटी,	
tughlaqabad,	तुगलाबाबाद,	तुगलकाबाद,	
jgaayega,	जगाएगा,	जगाएगा,	
oceanic,	ऑसेनिक,	ओशनिक,	
tyauharon,	त्योहारों,	त्यौहारों,	
urf,	आर्फ,	उर्फ,	
alliance,	एलायंस,	एलियंस,	
aapka,	आपका,	आपका,	
prapt,	प्राप्त,	प्राप्त,	
karvi,	कारवी,	कर्वी,	
fodon,	फोड़ों,	फोड़ों,	
tarfa,	तरफा,	तरफा,	
shutting,	शटटिंग,	शुटिंग,	
cateline,	कैटलिन,	कैटलिन,	
kusumalta,	कुसुमालता,	कुसुमलता,	
squash,	स्क्यूश,	स्क्वैश,	
dhyeyavaadi,	ध्येयवादी,	ध्येयवादी,	
phabti,	फाब्ती,	फब्ती,	
dilaaye,	दिलाए,	दिलाये,	
takara,	टाकारा,	टकरा,	
badhav,	बढ़ाव,	बढ़ाव,	
amanathi,	अमानाथी,	अमानती,	
picking,	पिकिंग,	पीकिंग,	
dukaanon,	दुकानों,	दुकानों,	
ronaldo,	रोनाल्डो,	रोनाल्डो,	
vlc,	वललीसी,	वीएलसी,	
qawwali,	क़व्वाली,	कव्वाली,	
najib,	नज़ीब,	नजीब,	
churcha,	चर्चा,	चर्चा,	
jimme,	जिम्मे,	जिम्मे,	
gae,	गाए,	गए,	
rigs,	रिग्स,	रिग्स,	
brant,	ब्रांट,	भ्रांत,	
benis,	बेनिस,	बेनिस,	
patkathayen,	पटकथाएं,	पटकथाएं,	
udakishunganj,	उदाकिशंगंज,	उदाकिशुनगंज,	
wonder,	वंडर,	वंडर,	
chidhate,	चिढ़ते,	चिढ़ते,	
karki,	करकी,	कार्की,	
rosario,	रोसरियो,	रोसारियो,	
devaapur,	देवापुर,	देवापुर,	
kaldvel,	कालद्वेल,	काल्डवेल,	
dhandhanya,	ढांधान्य,	धनधान्य,	
rihanna,	रिहानना,	रिहाना,	
teekon,	टीकों,	टीकों,	
singha,	सिंहा,	सिंहा,	
valve,	वाल्वे,	वाल्व,	
mamuli,	मामूली,	मामूली,	
launcher,	लानचर,	लांचर,	
sthitiyon,	स्थितियों,	स्थितियों,	
nectar,	नेक्टर,	नेक्टर,	
zawar,	जावर,	जावर,	
box,	बॉक्स,	बाॅक्स,	
dhundhi,	ढूंधी,	ढूंढी,	
nagarik,	नागरिक,	नागारिक,	
praan,	प्राण,	प्राण,	
beerganj,	बीरगंज,	बीरगंज,	
bahamas,	बहामस,	बहामास,	
mehkane,	महकाने,	महकने,	
grandhiyon,	ग्रांधियों,	ग्रंथियों,	
palmonari,	पाल्मोनारी,	पल्मोनरी,	
saraahi,	सराही,	सराही,	
bakhshne,	बख़शने,	बख्शने,	
reja,	रेजा,	रेजा,	
oxide,	ऑक्साइड,	ऑक्साइड,	
ramkot,	रामकोट,	रामकोट,	
juber,	जुबर,	जुबेर,	
dolne,	डोलने,	डोलने,	
maheman,	महेमन,	मेहमान,	
mejabani,	मेजबानी,	मेजबानी,	
risaney,	रिसने,	रिसने,	
ijajat,	इजाजत,	इजाजत,	
machaanon,	मचानों,	मचानों,	
kamere,	कमेरे,	कमेरे,	
leaderon,	लेडरों,	लीडरों,	
namankanon,	नमानकनों,	नामांकनों,	
agende,	एजेंडे,	एजेंडे,	
badam,	बादम,	बदाम,	
met,	मेट,	मेट,	
bandhte,	बांधते,	बांधते,	
cubeck,	क्यूक्क,	क्यूबेक,	
sharabon,	शराबों,	शराबों,	
regal,	रेगल,	रीगल,	
olavrishti,	ओलावृष्टि,	ओलावृष्टि,	
tir,	तीर,	तीर,	
menu,	मेनू,	मेनू,	
chithrkar,	चित्रकर,	चित्रकार,	
nikhar,	निखर,	निखर,	
mauritious,	मॉरीशनयस,	मॉरिशस,	
rana,	राना,	राणा,	
jalgti,	जलगती,	जलगति,	
parafin,	पराफीन,	पैराफिन,	
ashanka,	अशंका,	आशंका,	
prahlad,	प्रहलाद,	प्रह्लाद,	
tugalaki,	तुगलाकी,	तुगलकी,	
jivaniyaan,	जीवनियां,	जीवनियां,	
bahavalpur,	बहवललपुर,	बहावलपुर,	
muth,	मूठ,	मूठ,	
aliance,	एलायंस,	अलायंस,	
thirake,	थिराके,	थिरके,	
alagavavadi,	अलगगवादी,	अलगाववादी,	
karghe,	कार्घे,	करघे,	
dum,	डम,	डम,	
godara,	गोडारा,	गोदारा,	
pharmon,	फर्मों,	फार्मों,	
daglas,	दगलास,	डगलस,	
bhadakaaya,	भड़काय,	भड़काया,	
angrzi,	अंगरीजी,	अंग्रज़ी,	
abbot,	अब्बोट,	एबोट,	
praharak,	प्रहरक,	प्रहारक,	
eesa,	ईसा,	एेसा,	
mario,	मैरियो,	मारियो,	
pierson,	पियरसन,	पियरसन,	
atke,	एटके,	अटके,	
dabhoi,	दाभोई,	डभोई,	
hegde,	हेगड़े,	हेगडे,	
jayke,	जायके,	जायके,	
royals,	रॉयल्स,	रॉयल्स,	
mahakne,	महकने,	महकने,	
manzila,	मंजीला,	मंजिला,	
atake,	अटके,	अटके,	
tribunal,	ट्रिब्यूनल,	ट्रिब्यूनल,	
vedon,	वेडों,	वेदों,	
zalzale,	जलजले,	ज़लज़ले,	
yaatanaon,	यातनाओं,	यातनाओं,	
baldwin,	बलद्वीन,	बाल्डविन,	
swa,	स्व,	स्वा,	
kolorado,	कोलोराडो,	कोलोराडो,	
jaydayal,	जायदाल,	जयदयाल,	
dukke,	दुक्के,	दुक्के,	
patwari,	पतवारी,	पटवारी,	
prtigyaa,	प्रतिज्ञा,	प्रतिज्ञा,	
bantne,	बांटने,	बंटने,	
gochar,	गोचार,	गोचर,	
gajara,	गाजरा,	गजरा,	
rese,	रेस,	रेस,	
aasaan,	आसान,	आसान,	
maori,	मौरी,	माओरी,	
grihnagar,	गृहनागर,	गृहनगर,	
rajinaama,	राजिनामा,	राजीनामा,	
puraane,	पुराने,	पुराने,	
sanghanit,	संघनित,	संघनित,	
jeetod,	जीतोड़,	जीतोड़,	
wed,	वेड,	वेड,	
taza,	ताजा,	ताजा,	
bheed,	भीड,	भीड़,	
chaupati,	चौपती,	चौपाटी,	
jagaega,	जगाएगा,	जगाएगा,	
tarabai,	तरबाई,	ताराबाई,	
hariyali,	हरियाली,	हरियाली,	
ghanakar,	घनाकार,	घनाकार,	
samvedikaran,	संवेदीकरण,	संवेदीकरण,	
jeenon,	जीनों,	जीनों,	
vishwasniiyataa,	विश्वासनीयता,	विश्वसनीयता,	
buzy,	बुजी,	बिजी,	
bani,	बानी,	बानी,	
tanjavur,	तंजावूर,	तंजावुर,	
eyer,	एयर,	इअर,	
mhapauron,	महापोरों,	महापौरों,	
kalraj,	कलराज,	कलराज,	
dubna,	दुबना,	डूबना,	
higman,	हिग्मन,	हाइमन,	
mahin,	महीन,	महीन,	
virodhabhasi,	विरोधाभासी,	विरोधाभासी,	
watanukoollan,	वातानुकूलन,	वातानुकूलन,	
shasakon,	शासकों,	शासकों,	
aviral,	अविराल,	अविरल,	
anuprayogi,	अनुप्रोगी,	अनुप्रयोगों,	
dubana,	दुबना,	डूबना,	
isaiyon,	ईसाईयों,	ईसाइयों,	
moolchand,	मूलचंद,	मूलचंद,	
anton,	एंटों,	एंटोन,	
bhulataa,	भुलता,	भूलता,	
sadanand,	सदानंद,	सदानंद,	
jamuai,	जमुई,	जमुई,	
claris,	क्लारिस,	क्लेरिस,	
shitij,	शीतिज,	क्षितिज,	
bekaaboo,	बेकाबू,	बेकाबू,	
simtataa,	सिमताता,	सिमटता,	
bhairo,	भैरो,	भैरो,	
singer,	सिंगर,	सिंगार,	
hawalat,	हवलात,	हवालात,	
istife,	इस्टाइफ,	इस्तीफे,	
maksad,	मकसद,	मक्सद,	
sanskritiyan,	संस्कृतियां,	संस्कृतियां,	
aryama,	आर्यमा,	अर्यमा,	
sdueep,	स्पुयप,	सुदीप,	
pijja,	पिज्ज़ा,	पिज्जा,	
aalsi,	आलसी,	आलसी,	
jajon,	जाजों,	जजों,	
alps,	एल्प्स,	ऐल्प्स,	
bhugat,	भूगत,	भुगत,	
killi,	किल्ली,	किल्ली,	
firti,	फिरती,	फिरती,	
wanon,	वनों,	वाणों,	
guthalidar,	गुथलीदार,	गुठलीदार,	
rajasva,	राजस्व,	राजस्व,	
avaigyanik,	अवैज्ञानिक,	अवैज्ञानिक,	
bijak,	बिजक,	बीजक,	
galaxion,	गैलैक्सियों,	गैलेक्सियों,	
vahikayen,	वाहिकाएं,	वाहिकाएं,	
kaalpi,	काल्पी,	कालपी,	
badli,	बदली,	बदली,	
bagali,	बगली,	बागली,	
idol,	आईडोल,	आइडल,	
nirdeshikaa,	निर्देशिका,	निर्देशिका,	
pipli,	पिपली,	पिपली,	
phatane,	फटने,	फटने,	
sujain,	सुजाइन,	सुजैन,	
nigger,	निग्र,	निगर,	
emerald,	एमराल्ड,	एमरल्ड,	
adp,	एडीपी,	एडीपी,	
sabhyata,	सभ्यता,	सभ्यता,	
bagli,	बगली,	बागली,	
khaein,	खाएं,	खाएं,	
roopak,	रूपक,	रूपक,	
adhiik,	अधिक,	अधीक,	
gandha,	गांधा,	गंध,	
ghataya,	घटाया,	घटाया,	
traip,	ट्रेप,	ट्रैप,	
larry,	लेरी,	लैरी,	
legaa,	लेगा,	लेगा,	
jalgati,	जलगती,	जलगति,	
mukartey,	मुकरते,	मुकरते,	
antony,	एंटोनी,	एंटोनी,	
baapa,	बापा,	बापा,	
yugam,	युगम,	युग्म,	
saltnat,	साल्टनेट,	सल्तनत,	
vaigyanikata,	वैज्ञानिकता,	वैज्ञानिकता,	
reduction,	रेडक्शन,	रिडक्शन,	
shavakon,	शावकों,	शावकों,	
aasteen,	आस्तीन,	आस्तीन,	
prashikshu,	प्रशिक्षु,	प्रशिक्षु,	
khinchkar,	खिंचकर,	खिंचकर,	
rasaayanika,	रसायानिका,	रसायनिक,	
vastavik,	वास्ताविक,	वास्तविक,	
laati,	लाटी,	लाती,	
manga,	मंगा,	मांगा,	
acchi,	अच्छी,	अच्छी,	
bhola,	भोला,	भोला,	
lakshmighar,	लक्ष्मीघार,	लक्ष्मीधर,	
zamana,	ज़माना,	ज़माना,	
bhogte,	भोगते,	भोगते,	
sandarbhon,	संदर्भों,	संदर्भों,	
tuesday,	टुस्डे,	ट्यूजडे,	
gatishilata,	गतिशीलाता,	गतिशीलता,	
upabhokta,	उपभोक्त,	उपभोक्ता,	
jayalalitaa,	जयालालिता,	जयललिता,	
byavar,	ब्यावर,	ब्यावर,	
ladki,	लड़की,	लड़की,	
runners,	रनर,	रनर्स,	
gene,	जीने,	जैने,	
ubhara,	उभारा,	उभारा,	
badhotari,	बढ़ोतरी,	बढ़ोतरी,	
chatagaon,	चटगागां,	चटगांव,	
inhaletion,	इन्लेलियन,	इनहेलेशन,	
vibhram,	विभ्रम,	विभ्रम,	
dealership,	डेलरशिप,	डीलरशिप,	
end,	एंड,	ऐंठ,	
nakam,	नकाम,	नाकाम,	
vishnu,	विष्णु,	विष्णु,	
dhuni,	धुनी,	धूनी,	
snickers,	सिनिकर्स,	स्नीकर्स,	
niyanta,	नियंता,	नियंता,	
dhoondhata,	ढूंढता,	ढूंढता,	
iso,	इसो,	आइसो,	
ulemaon,	उलेमाओं,	उलेमाओं,	
mave,	मावे,	मावे,	
atharva,	अथर्वा,	अथर्व,	
alochakon,	आलोचकों,	आलोचकों,	
kaaji,	काजी,	काजी,	
talabgar,	तलबबर,	तलबगार,	
tip,	टीप,	टिप,	
chhupta,	छुप्टा,	छुपता,	
sanbharnt,	संभार्णत,	संभ्रांत,	
udhrva,	उधरवा,	ऊर्ध्व,	
dabhara,	दभारा,	डभरा,	
sanchalanon,	संचालनों,	संचालनों,	
mosad,	मोसद,	मोसाद,	
rabha,	रभा,	राभा,	
anik,	अनिक,	अनिक,	
hafate,	हफाते,	हांफते,	
tyoihar,	त्योहार,	त्यौहार,	
hamala,	हमाला,	हमला,	
composer,	कंपोसर,	कंपोजर,	
awasthaen,	अवस्थाएं,	अवस्थाएं,	
mode,	मोड़,	मॉड,	
swaachaalit,	स्वाचालित,	स्वाचालित,	
chhura,	छुरा,	छुरा,	
falibhoot,	फलीभूत,	फलीभूत,	
aayenge,	आयेंगे,	आयेंगे,	
lbada,	लबाड़ा,	लबादा,	
jha,	झा,	झ,	
seti,	सेती,	सेटी,	
samahaar,	समाहार,	समाहार,	
vangchuk,	वांगचूक,	वांगचुक,	
bhoogol,	भूगोल,	भूगोल,	
wrapping,	व्रैपिंग,	रैपिंग,	
uplabdhi,	उपलबबी,	उपलब्धी,	
jaljale,	जलजाले,	ज़लज़ले,	
gayen,	गाएं,	गाएं,	
pes,	पेस,	पेस,	
ccd,	सीसीडी,	सीसीडी,	
adhyayanarat,	अध्ययनरात,	अध्ययनरत,	
ripon,	रिपों,	रिपन,	
sealed,	सीलेड,	सील्ड,	
praakkathan,	प्रककठन,	प्राक्कथन,	
colon,	कोलों,	कोलन,	
vishwasniiya,	विश्वासनीय,	विश्वसनीय,	
tarkvaad,	तरकवाद,	तर्कवाद,	
daravani,	दरवानी,	डरावनी,	
akhet,	अखेत,	आखेट,	
sayra,	सायरा,	सायरा,	
machanno,	मचाननों,	मचानों,	
kaju,	काजू,	काजू,	
vansh,	वंश,	वंश,	
pardaa,	परदा,	पर्दा,	
gujare,	गुजरे,	गुजारे,	
fagua,	फागुआ,	फगुआ,	
bethnal,	बेथनाल,	बेथनल,	
aithan,	ऐंठन,	ऐठन,	
shanivar,	शानीवार,	शनिवार,	
suta,	सूता,	सुता,	
kangan,	कांगन,	कंगन,	
dulne,	दूलने,	डुलने,	
damle,	डमले,	दामले,	
janagananaa,	जनगानान,	जनगणना,	
hippo,	हिप्पो,	हिप्पो,	
punjabiyon,	पुंजाियों,	पंजाबियों,	
aagaman,	आगमन,	आगमन,	
avru,	अवरू,	अवरु,	
nihaalchand,	निहालचंद,	निहालचंद,	
daataa,	दाता,	दाता,	
keede,	कीडे,	कीड़े,	
emi,	एमी,	एमी,	
skala,	स्कला,	स्काला,	
darjano,	दर्जनों,	दर्जनों,	
parishadon,	परिशादों,	परिषदों,	
stray,	स्ट्रे,	स्ट्रे,	
lindn,	लिंडन,	लिंडन,	
yada,	यादा,	यदा,	
stress,	स्ट्रेस,	स्ट्रास,	
lasoon,	लासून,	लहसुन,	
hijbul,	हिजबूल,	हिजबुल,	
lapetne,	लपेटने,	लपेटने,	
amarpal,	अमरपाल,	अमरपाल,	
melaani,	मेलानी,	मेलानी,	
aapdayein,	आपदाएं,	आपदाएं,	
doonarpur,	दूनारपुर,	डूंगरपुर,	
samahar,	समाहार,	समाहार,	
parikalpit,	परिकल्पित,	परिकल्पित,	
rukte,	रूकते,	रुकते,	
hamlavar,	हमलावर,	हमलावर,	
faansi,	फांसी,	फांसी,	
qazi,	काज़ी,	काजी,	
bhuswami,	भूस्वामी,	भूस्वामी,	
badhaati,	बढ़ाती,	बढ़ाती,	
bagichi,	बगीची,	बगीची,	
jeewan,	जीवन,	जीवन,	
adharit,	अधारित,	आधारित,	
kasht,	काष्ट,	काश्त,	
rita,	रीता,	रीता,	
tivolee,	तिवोली,	टिवोली,	
samadhan,	समाधान,	समाधान,	
dav,	दाव,	दाव,	
offshore,	आफफार,	ऑफशोर,	
baramad,	बरामद,	बरामद,	
sukhati,	सूखती,	सूखती,	
ladaaiyon,	लड़ाइयों,	लड़ाईयों,	
gujarta,	गुजरता,	गुजारता,	
farm,	फर्म,	फार्म,	
pr,	पीआर,	पीआर,	
jorhta,	जोड़ता,	जोड़ता,	
shravani,	श्रववनी,	श्रावणी,	
bastiyon,	बस्तियों,	बस्तियों,	
gadkar,	गाड़कर,	गडकर,	
ardaas,	अरदास,	अरदास,	
jaine,	जैने,	जैने,	
naraingarh,	नारैंगढ़,	नारायणगढ़,	
taras,	तारस,	तरस,	
uthaapatak,	उठापतक,	उठापटक,	
mahipal,	महिपाल,	महिपाल,	
satti,	सत्ती,	सत्ती,	
bisawan,	बीसवां,	बीसवां,	
equities,	एक्शिजीज,	इक्विटीज,	
swap,	स्वप,	स्वैप,	
log,	लॉग,	लोग,	
menon,	मेनों,	मैनन,	
fisla,	फिसला,	फिसला,	
vaadak,	वादक,	वादक,	
janjaagran,	जनजागरण,	जनजागरण,	
ubuntu,	उबुंतु,	उबंटू,	
ambani,	अंबानी,	अंबानी,	
girjaghar,	गिरजाघर,	गिरजाघर,	
amogh,	अमोघ,	अमोघ,	
spell,	स्पेल,	स्पेल,	
tirupati,	तिरुपति,	तिरूपति,	
dhuan,	धुआन,	धुआं,	
deputy,	डिप्टी,	डेप्युटी,	
avarnataa,	अवर्नता,	अवर्णता,	
naksalavaad,	नकसलावाद,	नक्सलवाद,	
mahanideshak,	महानिदेशक,	महानिदेशक,	
moodi,	मूडी,	मूडी,	
sanghnit,	संघनित,	संघनित,	
badhachadhakar,	बढ़चाधाकार,	बढ़ाचढ़ाकर,	
fact,	फैक्ट,	फैक्ट,	
harna,	हरना,	हारना,	
sujhati,	सुझाती,	सुझाती,	
obrayan,	ओब्रायन,	ओब्रायन,	
adad,	अदाद,	अदद,	
hasino,	हसीनो,	हसीनों,	
lahrai,	लहराई,	लहराई,	
antrmukh,	अंतरमुख,	अंतर्मुख,	
kankad,	कांकड़,	कंकर,	
sajsajja,	सजसजजा,	साजसज्जा,	
kundaliyan,	कुंडलियां,	कुंडलियाँ,	
divya,	दिव्य,	दिव्या,	
bhairavnath,	भैरवानथ,	भैरवनाथ,	
danpati,	दनपती,	दंपति,	
utaney,	उतने,	उतने,	
taste,	टस्ते,	टेस्ट,	
samprti,	संपर्ति,	संप्रति,	
rig,	रिग,	रिग,	
granthiyaan,	गृंठियां,	ग्रंथियां,	
vigyanon,	विज्ञानों,	विज्ञानों,	
airway,	एयरवे,	एयरवे,	
mehram,	मेहराम,	मेहराम,	
mezbaan,	मेजबान,	मेज़बान,	
maukon,	मौकों,	मौकों,	
sulaati,	सुलाती,	सुलाती,	
sarganaon,	सरगगानओं,	सरगनाओं,	
nirdhaarit,	निर्धारित,	निर्धारित,	
urfa,	उरफा,	उर्फ,	
xm,	एसएम,	एक्सएम,	
upbhokta,	उपभोकता,	उपभोक्ता,	
charas,	चारस,	चरस,	
sisva,	सिस्व,	सिसवा,	
lengdan,	लेंगड़न,	लैंगडन,	
mtech,	मटेच,	एमटेक,	
ralhan,	रालहन,	रल्हन,	
putlaa,	पुतला,	पुतला,	
kamzor,	कमजोर,	कमज़ोर,	
stra,	स्त्र,	स्ट्रे,	
padamawati,	पदमावती,	पदमावती,	
kalpi,	कल्पी,	कालपी,	
fortis,	फोर्टिस,	फोर्टिस,	
naukari,	नौकरी,	नोकरी,	
mukarte,	मुकरते,	मुकरते,	
taboo,	तबू,	टैबू,	
vichaarakon,	विचारकों,	विचारकों,	
mausa,	मौसा,	मौसा,	
lutf,	लट्फ,	लुत्फ,	
nihlani,	निहलानी,	निहलानी,	
yarushalem,	यरुशलेम,	यरूशलेम,	
khanikarm,	खानिकर्म,	खनिकर्म,	
bostan,	बोस्तान,	बॉस्टन,	
velur,	वेलुर,	वेल्लूर,	
jwaron,	ज्वारों,	ज्वारों,	
mol,	मोल,	मोल,	
amuk,	अमूक,	अमुक,	
sinabang,	सिनाबांग,	सिनाबंग,	
naasar,	नासर,	नासर,	
vaimanasy,	वैमानसीय,	वैमनस्य,	
viththal,	विथल्थल,	विठ्ठल,	
brahmleen,	ब्रह्मलीन,	ब्रह्मलीन,	
dikhla,	दिखला,	दिखला,	
transistor,	ट्रांसिस्टर,	ट्रांजिस्टर,	
yatraen,	यात्राएं,	यात्राएं,	
ia,	आईए,	ईए,	
taul,	तौल,	तौल,	
rais,	रैस,	रईस,	
hercules,	हर्कल्स,	हरक्यूलिस,	
asan,	असन,	आसान,	
bhisham,	भिष्म,	भीष्म,	
failaiya,	फैलाइया,	फैलाइए,	
brahmalin,	ब्रह्मालीन,	ब्रह्मलीन,	
saimans,	सैमांस,	साइमंस,	
takra,	टकरा,	टकरा,	
jaayke,	जायके,	जायके,	
dadari,	दादरी,	दादरी,	
breed,	ब्रीड,	ब्रीद,	
aavriti,	आवृति,	आवृत्ति,	
mithilanchal,	मिथिलांचल,	मिथिलांचल,	
laurence,	लॉरेंस,	लौरेंस,	
ballistic,	बैलिस्टिक्स,	बैलिस्टिक,	
mashrak,	मशर्क,	मशरक,	
bhugta,	भूगता,	भुगता,	
bahuly,	बहुल्य,	बाहुल्य,	
pathshalayen,	पाठशालाएं,	पाठशालाएं,	
dipika,	दीपिका,	दीपिका,	
bikaneri,	बिकनेरी,	बीकानेरी,	
lassi,	लासी,	लस्सी,	
falata,	फलता,	फलता,	
thanjavur,	ठंजावूर,	तंजावुर,	
lbdh,	एलब्ध,	लब्ध,	
kasrat,	कसरत,	कसरत,	
ghumakkadi,	घुमककादी,	घुमक्कड़ी,	
chamakna,	चमकना,	चमकना,	
pehnati,	पहनती,	पहनाती,	
bhavnaon,	भववानों,	भावनाओं,	
dikhayi,	दिखाई,	दिखायी,	
tonga,	टोंगा,	टोंगा,	
thaili,	थैली,	थैली,	
bheera,	भीरा,	भीरा,	
beast,	बेस्ट,	बीस्ट,	
ahsaas,	अहसास,	एहसास,	
lootmar,	लूटमार,	लूटमार,	
apvartit,	अपवर्तित,	अपवर्तित,	
fode,	फोड़,	फोड़े,	
auchitya,	औछित्य,	औचित्य,	
prakriya,	प्रक्रिय,	प्रक्रिया,	
aswabhavik,	अस्वाभाविक,	अस्वभाविक,	
jinon,	जीनों,	जीनों,	
ujback,	उजबैक,	उज़्बेक,	
ghot,	घोट,	घोट,	
bandhti,	बांधती,	बंधती,	
patachep,	पतचेप,	पटाक्षेप,	
sprint,	स्प्रिंट,	स्प्रिट,	
paraffin,	परफफीन,	पैराफिन,	
two,	ट्वो,	टु,	
rodolph,	रोडोल्फ,	रुडोल्फ,	
fus,	फस,	फूस,	
vasharan,	वारण,	वर्शन,	
barsaata,	बरसाता,	बरसाता,	
tension,	टेंसन,	टेंशन,	
suba,	सूबा,	सूबा,	
westinghouse,	वेस्टिंगस,	वेस्टिंगहाउस,	
panaamaa,	पनामा,	पनामा,	
daak,	डाक,	डाक,	
thirty,	थर्टी,	थर्टी,	
navvadhoo,	नववाधु,	नववधू,	
tik,	टीक,	टिक,	
swiftlet,	स्विफ्टेट,	स्विफ्टलेट,	
phod,	फोड,	फोड़,	
panapnaa,	पनापना,	पनपना,	
bhuli,	भुली,	भूली,	
kathfodve,	कथ्डोडवे,	कठफोड़वे,	
deonar,	डियोनर,	देवनार,	
nrityon,	नृत्यों,	नृत्यों,	
layega,	लाएगा,	लायेगा,	
emily,	एमिली,	एमिल,	
nauu,	नौऊ,	नाऊ,	
kaetholikon,	कैथोलिकों,	कैथोलिकों,	
jud,	जुड़,	जूड,	
amzera,	अमजेरा,	अमझेरा,	
bauni,	बौनी,	बौनी,	
gidgidate,	गिडगिड़ते,	गिड़गिड़ाते,	
shamadan,	शमादन,	शमादान,	
vash,	वाश,	वश,	
aavritiyon,	आवृतियों,	आवृत्तियों,	
alance,	एलांस,	अलायंस,	
mangesh,	मंगेश,	मंगेश,	
apj,	अपज,	एपीजे,	
dastaanaa,	दस्ताना,	दस्ताना,	
vruton,	वृतों,	वृत्तों,	
sataane,	सताने,	सताने,	
farheen,	फरहीन,	फरहीन,	
malaar,	मलार,	मलार,	
yatraein,	यात्राएं,	यात्राएं,	
najim,	नाजिम,	नजीम,	
achhanera,	अछानेरा,	अछनेरा,	
aryika,	आर्यिका,	आर्यिका,	
gandki,	गांडकी,	गंडकी,	
kanaal,	कनाल,	कनाल,	
nagaada,	नगाड़ा,	नगाड़ा,	
aalhaa,	आल्हा,	आल्हा,	
kamaauu,	कमाऊ,	कमाऊ,	
sanchayan,	संचायां,	संचयन,	
roya,	रोया,	रोया,	
chhai,	छाई,	छाई,	
email,	एमैल,	ईमेल,	
taseer,	तैसीर,	तासीर,	
hiraganj,	हिरागंज,	हीरागंज,	
lahraee,	लहराई,	लहराई,	
soochak,	सूचक,	सूचक,	
weldor,	वेल्डर,	वेल्डर,	
khaibar,	खैबर,	ख़ैबर,	
gruhnagar,	गृहनागर,	गृहनगर,	
sathiya,	सथिया,	साथिया,	
uplakshay,	उपलक्षय,	उपलक्ष्य,	
angaarak,	अंगारक,	अंगारक,	
noon,	नू,	नून,	
robin,	रॉबीन,	राबिन,	
udaanaa,	उड़ना,	उड़ाना,	
emelon,	एमेलों,	ईमेलों,	
sasakon,	सासकों,	शासकों,	
denewali,	देनेवाली,	देनेवाली,	
plan,	प्लान,	प्लेन,	
bhumi,	भूमि,	भुमि,	
trangistor,	ट्रांजिस्टर,	ट्रांजिस्टर,	
roopi,	रूपी,	रूपी,	
ashriri,	अश्रीरी,	अशरीरी,	
sambhalne,	संभालने,	संभालने,	
uplakshya,	उपलाक्षय,	उपलक्ष्य,	
boliy,	बोलीय,	बोलिए,	
vyabhichar,	व्याभीचार,	व्यभिचार,	
theatre,	ठीटरे,	थियेटर,	
risane,	रिसने,	रिसने,	
charts,	चार्ट्स,	चार्ट्स,	
panter,	पैंटर,	पंटर,	
matsyavatar,	मत्स्यावातार,	मत्स्यावतार,	
jamaanaa,	जमाना,	ज़माना,	
khat,	खाट,	खत,	
sabhasadon,	सभासदों,	सभासदों,	
tughlakabad,	तुगलाबाबाद,	तुगलकाबाद,	
balti,	बलती,	बाल्टी,	
dhakkal,	धक्कल,	ढकाल,	
chahunor,	चाहनोर,	चहुंओर,	
fefda,	फेफ्डा,	फेफड़ा,	
immune,	इम्यून,	इम्युन,	
batlakar,	बतलाकर,	बतलाकर,	
jubaan,	जुबान,	ज़ुबान,	
ilaaj,	इलाज,	इलाज,	
tenin,	टेनिन,	टैनिन,	
aagat,	आगत,	आगत,	
chhupakar,	छुपाकर,	छुपकर,	
abhishap,	अभिशाप,	अभिशाप,	
najraane,	नजराने,	नजराने,	
judaai,	जुडाई,	जुड़ाई,	
aisa,	एसा,	एेसा,	
kasim,	कसीम,	कासिम,	
transfer,	ट्रांसफर,	ट्रान्सफर,	
phurti,	फूर्ती,	फूर्ति,	
gatishil,	गतिशील,	गतिशील,	
oklahoma,	ओक्लाहोमा,	ओक्लाहोमा,	
salve,	सलवे,	साल्वे,	
socar,	सोकर,	सॉकर,	
bandage,	बैंडेग,	बैंडेज,	
sochne,	सोचने,	सोचने,	
bisavan,	बीसवन,	बीसवां,	
anyaay,	अन्याय,	अन्याय,	
colorado,	कोरोडो,	कोलोराडो,	
dose,	डोस,	डोज,	
hilane,	हिलाने,	हिलने,	
matsyavtar,	मत्स्यवत्र,	मत्स्यावतार,	
bhishm,	भिष्म,	भीष्म,	
kachche,	कच्छे,	कच्चे,	
ratanpur,	रतनपुर,	रतनपुर,	
saathsaath,	साथसाथ,	साथसाथ,	
vesh,	वेष,	वेश,	
vise,	वीज,	वाइज,	
khand,	खंड,	खंडा,	
bhaunho,	भौनोह,	भौंहों,	
pahantaa,	पहनता,	पहनता,	
budwig,	बुद्वीग,	बुडविग,	
madaura,	मदौरा,	मढ़ौरा,	
kranj,	क्रांज,	करंज,	
mehaman,	महहमन,	मेहमान,	
bhaskar,	भस्कर,	भास्कर,	
vaigyanikta,	वैज्ञानिकता,	वैज्ञानिकता,	
dalbadal,	दलबदल,	दलबदल,	
samitiyan,	समितियां,	समितियां,	
